id,Counts_1st,Counts_2nd,Counts_3rd,Counts_4th,Total_Counts,Uniprot_id_gene,Uniprot_entry,pldt_score
RVBD3596c:clpC1,9,8,11,8,36,RV3596c,P9WPC9,82.72406768798828
RVBD1828:RVBD1828,10,5,13,6,34,RV1828,P9WME7,83.6622314453125
RVBD0430:RVBD0430,10,7,10,7,34,RV0430,P96276,75.1827392578125
RVBD2093c:tatC,7,7,11,7,32,RV2093c,P9WG97,83.05223846435547
RVBD0732:secY,10,6,9,7,32,RV0732,P9WGN3,74.1700210571289
RVBD0668:rpoC,8,5,12,7,32,RV0668,P9WGY7,88.39871978759766
RVBD1697:RVBD1697,7,6,11,7,31,RV1697,O33198,88.3404312133789
RVBD0482:murB,10,7,7,7,31,RV0482,P9WJL9,93.93362426757812
RVBD0014c:pknB,8,8,8,7,31,RV0014c,P9WI81,84.32803344726562
RVBD2150c:ftsZ,9,6,11,5,31,RV2150c,P9WN95,81.90878295898438
RVBD0206c:mmpL3,9,4,10,7,30,RV0206c,P9WJV5,78.99099731445312
RVBD3808c:glfT2,8,5,10,7,30,RV3808c,O53585,93.87205505371094
RVBD3246c:mtrA,8,6,11,5,30,RV3246c,P9WGM7,92.35977935791016
RVBD2925c:rnc,7,6,11,6,30,RV2925c,P9WH03,90.70362854003906
RVBD3645:RVBD3645,6,6,11,6,29,RV3645,I6X7Z3,86.33210754394531
RVBD1480:RVBD1480,8,7,9,5,29,RV1480,P9WLX5,84.8407211303711
RVBD0667:rpoB,8,5,10,6,29,RV0667,P9WGY9,91.20294952392578
RVBD0058:dnaB,7,6,11,5,29,RV0058,P9WMR3,81.20580291748047
RVBD1302:rfe,7,6,11,5,29,RV1302,P9WMW5,81.19029235839844
RVBD0227c:RVBD0227c,9,5,8,7,29,RV0227c,P96409,85.53106689453125
RVBD2165c:RVBD2165c,9,6,8,5,28,RV2165c,P9WJP1,82.420654296875
RVBD3240c:secA1,9,4,10,5,28,RV3240c,P9WGP5,83.25385284423828
RVBD0015c:pknA,8,7,8,5,28,RV0015c,P9WI83,76.99836730957031
RVBD2200c:ctaC,7,4,11,6,28,RV2200c,P9WP69,90.11170196533203
RVBD0005:gyrB,9,8,7,4,28,RV0005,P9WG45,88.55223846435547
RVBD3043c:ctaD,6,4,12,6,28,RV3043c,P9WP71,94.57856750488281
RVBD1223:htrA,6,5,12,5,28,RV1223,O06291,78.79134368896484
RVBD3048c:nrdF2,7,6,9,5,27,RV3048c,P9WH71,90.8703384399414
RVBD2969c:RVBD2969c,9,6,9,3,27,RV2969c,O33272,90.67266845703125
RVBD3285:accA3,7,5,8,6,26,RV3285,P96890,88.29661560058594
RVBD3583c:RVBD3583c,8,5,9,4,26,RV3583c,P9WJG3,90.42222595214844
RVBD2361c:RVBD2361c,6,6,10,4,26,RV2361c,P9WFF7,93.53540802001953
RVBD2460c:clpP2,9,6,9,2,26,RV2460c,P9WPC3,92.52617645263672
RVBD0006:gyrA,9,7,6,4,26,RV0006,P9WG47,88.58765411376953
RVBD0001:dnaA,8,3,10,5,26,RV0001,P9WNW3,81.20765686035156
RVBD0903c:prrA,7,4,11,4,26,RV0903c,P9WGM1,89.39982604980469
RVBD2145c:wag31,7,6,9,4,26,RV2145c,P9WMU1,83.39811706542969
RVBD0638:secE1,7,6,7,5,25,RV0638,P9WGN7,64.67633819580078
RVBD1111c:RVBD1111c,6,4,9,6,25,RV1111c,O86351,52.06822204589844
RVBD0543c:RVBD0543c,7,5,8,5,25,RV0543c,O06409,80.71881103515625
RVBD3809c:glf,6,5,9,5,25,RV3809c,P9WIQ1,95.08711242675781
RVBD2926c:RVBD2926c,9,4,8,4,25,RV2926c,P9WL17,86.04801940917969
RVBD2182c:RVBD2182c,6,4,9,6,25,RV2182c,O53516,85.26736450195312
RVBD1830:RVBD1830,6,6,8,5,25,RV1830,P9WME5,77.21186828613281
RVBD3783:rfbD,8,4,8,4,24,RV3783,P72049,90.8611831665039
RVBD0002:dnaN,7,4,8,5,24,RV0002,P9WNU1,91.94042205810547
RVBD2846c:efpA,5,6,9,4,24,RV2846c,P9WJY5,85.48052978515625
RVBD2201:asnB,6,6,8,4,24,RV2201,P9WN33,92.88099670410156
RVBD3051c:nrdE,8,4,8,4,24,RV3051c,P9WH75,92.30706787109375
RVBD2783c:gpsI,6,5,8,5,24,RV2783c,P9WI57,90.76472473144531
RVBD0383c:RVBD0383c,7,3,9,5,24,RV0383c,O53718,79.38524627685547
RVBD1477:ripA,7,4,9,4,24,RV1477,O53168,83.24695587158203
RVBD1708:RVBD1708,7,5,7,5,24,RV1708,P9WLT1,87.12496948242188
RVBD2968c:RVBD2968c,7,6,8,3,24,RV2968c,I6X5W1,85.63162231445312
RVBD2195:qcrA,6,6,8,4,24,RV2195,P9WH23,88.74690246582031
RVBD3457c:rpoA,6,5,9,4,24,RV3457c,P9WGZ1,85.52227783203125
RVBD3245c:mtrB,6,5,9,4,24,RV3245c,P9WGK9,83.5311279296875
RVBD0639:nusG,6,6,7,5,24,RV0639,P9WIU9,76.86902618408203
RVBD1311:atpC,8,4,8,4,24,RV1311,P9WPV1,94.4989242553711
RVBD3778c:RVBD3778c,7,5,8,4,24,RV3778c,P9WQ67,96.38720703125
RVBD2196:qcrB,6,5,9,4,24,RV2196,P9WP37,94.81192779541016
RVBD0431:RVBD0431,7,5,7,4,23,RV0431,P96277,68.81097412109375
RVBD0529:ccsA,7,5,8,3,23,RV0529,O06393,85.77198028564453
RVBD1023:eno,8,6,7,2,23,RV1023,P9WNL1,96.66244506835938
RVBD3781:rfbE,7,5,8,3,23,RV3781,P72047,88.70355224609375
RVBD0716:rplE,7,7,5,4,23,RV0716,P9WH83,91.38802337646484
RVBD2927c:RVBD2927c,8,2,7,6,23,RV2927c,P9WL15,92.12799835205078
RVBD3859c:gltB,6,4,9,4,23,RV3859c,P96218,93.02359771728516
RVBD1436:gap,6,4,8,5,23,RV1436,P9WN83,97.61896514892578
RVBD2194:qcrC,7,4,9,3,23,RV2194,P9WP35,88.61378479003906
RVBD3801c:fadD32,5,5,8,5,23,RV3801c,O53580,89.30545043945312
RVBD1547:dnaE1,8,5,6,4,23,RV1547,P9WNT7,89.38251495361328
RVBD1308:atpA,6,5,9,3,23,RV1308,P9WPU7,92.06267547607422
RVBD0884c:serC,6,6,8,3,23,RV0884c,P9WQ73,97.34619903564453
RVBD1827:garA,8,5,8,2,23,RV1827,P9WJA9,68.0057373046875
RVBD3265c:wbbL1,6,4,8,5,23,RV3265c,P9WMY3,89.50133514404297
RVBD2193:ctaE,7,4,9,3,23,RV2193,P9WP67,90.75117492675781
RVBD0126:treS,7,5,8,3,23,RV0126,P9WQ19,92.6319580078125
RVBD2156c:murX,6,5,8,4,23,RV2156c,P9WMW7,93.2807846069336
RVBD3248c:sahH,6,6,8,3,23,RV3248c,P9WGV3,96.27792358398438
RVBD3764c:tcrY,7,6,7,3,23,RV3764c,O69729,87.19515991210938
RVBD2592c:ruvB,8,3,6,6,23,RV2592c,P9WGW1,90.16619110107422
RVBD3587c:RVBD3587c,6,4,8,4,22,RV3587c,O53572,81.45768737792969
RVBD3436c:glmS,8,4,7,3,22,RV3436c,P9WN49,93.13676452636719
RVBD2524c:fas,5,3,10,4,22,RV2524c,P95029,
RVBD2703:sigA,7,4,7,4,22,RV2703,P9WGI1,71.30770874023438
RVBD1310:atpD,6,4,8,4,22,RV1310,P9WPU5,88.49044799804688
RVBD3794:embA,6,2,8,6,22,RV3794,P9WNL9,94.96377563476562
RVBD3260c:whiB2,6,5,7,4,22,RV3260c,O53353,78.31214141845703
RVBD1007c:metS,6,6,8,2,22,RV1007c,P9WFU5,94.96214294433594
RVBD3909:RVBD3909,6,4,8,4,22,RV3909,O05436,86.57005310058594
RVBD3646c:topA,6,4,7,5,22,RV3646c,P9WG49,88.93400573730469
RVBD0337c:aspC,6,6,6,4,22,RV0337c,P9WQ91,93.94503784179688
RVBD2682c:dxs1,5,5,7,5,22,RV2682c,P9WNS3,91.12332153320312
RVBD1483:fabG1,7,5,7,3,22,RV1483,P9WGT3,95.67967224121094
RVBD1479:moxR1,7,5,7,3,22,RV1479,Q79FN7,85.66676330566406
RVBD0824c:desA1,6,5,7,3,21,RV0824c,P9WNZ7,94.01606750488281
RVBD2147c:RVBD2147c,8,2,8,3,21,RV2147c,P9WGJ5,67.58692169189453
RVBD3101c:ftsX,6,6,6,3,21,RV3101c,P9WG19,88.06404113769531
RVBD2673:aftC,6,4,7,4,21,RV2673,P9WMZ7,91.99151611328125
RVBD3277:RVBD3277,6,4,7,4,21,RV3277,P96882,55.06315994262695
RVBD1224:tatB,5,4,8,4,21,RV1224,P9WG99,73.74862670898438
RVBD2461c:clpP1,7,5,7,2,21,RV2461c,P9WPC5,90.57051086425781
RVBD3800c:pks13,6,5,7,3,21,RV3800c,I6X8D2,83.3399429321289
RVBD3257c:pmmA,6,4,8,3,21,RV3257c,O86374,95.99769592285156
RVBD3918c:parA,7,3,7,4,21,RV3918c,Q1LVD4,83.2435531616211
RVBD1094:desA2,7,3,6,5,21,RV1094,P9WNZ5,97.04996490478516
RVBD2890c:rpsB,6,6,5,4,21,RV2890c,P9WH39,84.37818145751953
RVBD2572c:aspS,4,6,7,4,21,RV2572c,P9WFW3,94.1961441040039
RVBD1611:trpC,5,4,8,4,21,RV1611,P9WFX7,94.99764251708984
RVBD1166:lpqW,6,4,8,3,21,RV1166,P9WGU7,87.33946228027344
RVBD0701:rplC,5,7,5,4,21,RV0701,P9WH87,93.86346435546875
RVBD1304:atpB,6,6,6,3,21,RV1304,P9WPV7,55.05112075805664
RVBD6019:23S,5,5,7,4,21,RV6019,,
RVBD2198c:mmpS3,7,3,8,3,21,RV2198c,P9WJT1,68.18618774414062
RVBD1463:RVBD1463,7,5,6,3,21,RV1463,O53154,92.3786392211914
RVBD0225:RVBD0225,7,4,7,3,21,RV0225,P96407,95.12588500976562
RVBD2748c:ftsK,7,5,5,4,21,RV2748c,P9WNA3,79.06261444091797
RVBD3355c:RVBD3355c,7,4,7,3,21,RV3355c,O50384,93.05660247802734
RVBD3336c:trpS,5,7,6,3,21,RV3336c,P9WFT3,93.91949462890625
RVBD2174:mptA,6,5,7,3,21,RV2174,O53508,93.29759979248047
RVBD2981c:ddlA,8,4,7,2,21,RV2981c,P9WP31,90.94963073730469
RVBD0810c:RVBD0810c,6,4,7,3,20,RV0810c,I6XWB9,76.59516906738281
RVBD2457c:clpX,7,5,5,3,20,RV2457c,P9WPB9,80.14413452148438
RVBD1423:whiA,6,3,7,4,20,RV1423,P9WF45,94.33216857910156
RVBD3913:trxB2,6,2,9,3,20,RV3913,P9WHH1,91.9044418334961
RVBD3462c:infA,8,5,5,2,20,RV3462c,P9WKK3,84.83712768554688
RVBD1451:ctaB,6,3,8,3,20,RV1451,P9WFR7,89.75963592529297
RVBD0204c:RVBD0204c,6,5,7,2,20,RV0204c,I6Y748,71.71546173095703
RVBD3709c:ask,5,5,6,4,20,RV3709c,P9WPX3,93.79679107666016
RVBD2612c:pgsA1,6,3,8,3,20,RV2612c,P9WPG7,92.73055267333984
RVBD0440:groEL2,6,3,8,3,20,RV0440,P9WPE7,91.64195251464844
RVBD1389:gmk,5,5,7,3,20,RV1389,P9WKE9,88.89404296875
RVBD6043:tRNA-Ser41,7,3,5,5,20,RV6043,,
RVBD0236A:RVBD0236A,6,4,7,3,20,RV0236A,P9WLB1,83.08368682861328
RVBD1636:TB15.3,6,4,7,3,20,RV1636,P9WFC9,88.88218688964844
RVBD3244c:lpqB,6,3,8,3,20,RV3244c,P9WK37,91.53132629394531
RVBD1642:rpmI,5,4,8,3,20,RV1642,P9WH91,92.71234130859375
RVBD3782:glfT1,5,4,7,4,20,RV3782,P9WMX3,92.17628479003906
RVBD1683:RVBD1683,7,4,6,3,20,RV1683,O33185,84.09624481201172
RVBD0338c:RVBD0338c,6,2,8,4,20,RV0338c,O33268,82.56487274169922
RVBD3799c:accD4,7,3,7,3,20,RV3799c,O53578,95.24937438964844
RVBD3834c:serS,6,4,7,3,20,RV3834c,P9WFT7,95.84426879882812
RVBD1381:pyrC,6,5,7,2,20,RV1381,P9WHL3,97.34146881103516
RVBD2916c:ffh,6,4,7,3,20,RV2916c,P9WGD7,75.83184814453125
RVBD1297:rho,7,3,5,5,20,RV1297,P9WHF3,76.9057846069336
RVBD2555c:alaS,6,5,6,3,20,RV2555c,P9WFW7,89.84540557861328
RVBD2229c:RVBD2229c,9,2,6,3,20,RV2229c,P9WLH3,93.49420928955078
RVBD3302c:glpD2,5,4,7,4,20,RV3302c,P9WN79,92.63653564453125
RVBD0384c:clpB,6,5,5,4,20,RV0384c,P9WPD1,88.08903503417969
RVBD1326c:glgB,5,5,6,4,20,RV1326c,P9WN45,95.60752868652344
RVBD1309:atpG,6,3,8,3,20,RV1309,P9WPU9,90.04157257080078
RVBD1306:atpF,6,4,7,3,20,RV1306,P9WPV5,86.60993957519531
RVBD1476:RVBD1476,7,3,6,3,19,RV1476,O53167,87.67650604248047
RVBD0703:rplW,6,4,6,3,19,RV0703,P9WHB9,91.92660522460938
RVBD3598c:lysS,5,5,7,2,19,RV3598c,P9WFU9,93.9749526977539
RVBD3793:embC,6,4,6,3,19,RV3793,P9WNL5,90.33694458007812
RVBD2357c:glyS,7,4,6,2,19,RV2357c,P9WFV7,93.22085571289062
RVBD0808:purF,5,2,8,4,19,RV0808,P9WHQ7,85.76825714111328
RVBD6007:tRNA-Trp8,7,4,6,2,19,RV6007,,
RVBD0364:RVBD0364,4,5,7,3,19,RV0364,P9WP09,79.80210876464844
RVBD6004:tRNA-Tyr5,7,4,6,2,19,RV6004,,
RVBD2921c:ftsY,6,4,6,3,19,RV2921c,P9WGD9,78.96665954589844
RVBD2243:fabD,5,3,7,4,19,RV2243,P9WNG5,97.27754974365234
RVBD3908:mutT4,6,3,7,3,19,RV3908,P9WIX7,79.64556884765625
RVBD3795:embB,6,3,6,4,19,RV3795,P9WNL7,92.6974868774414
RVBD2581c:RVBD2581c,4,5,7,3,19,RV2581c,P9WMW3,93.69371032714844
RVBD6023:tRNA-Pro21,5,5,6,3,19,RV6023,,
RVBD3280:accD5,5,3,8,3,19,RV3280,P9WQH7,95.30135345458984
RVBD3396c:guaA,6,3,8,2,19,RV3396c,P9WMS7,87.84950256347656
RVBD0526:RVBD0526,6,3,7,3,19,RV0526,O06392,86.60440063476562
RVBD3806c:ubiA,5,3,8,3,19,RV3806c,P9WFR5,90.78128814697266
RVBD0357c:purA,6,3,7,3,19,RV0357c,P9WHN3,93.60610961914062
RVBD1159:pimE,6,4,6,3,19,RV1159,P9WN01,88.94830322265625
RVBD2845c:proS,6,3,7,3,19,RV2845c,P9WFT9,95.26314544677734
RVBD1481:RVBD1481,6,3,7,3,19,RV1481,P9WFJ7,84.97058868408203
RVBD1390:rpoZ,6,5,6,2,19,RV1390,P9WGY5,82.95389556884766
RVBD0060:RVBD0060,7,3,5,4,19,RV0060,O53605,91.82091522216797
RVBD1110:lytB2,6,3,7,3,19,RV1110,P9WKG1,93.241455078125
RVBD2110c:prcB,6,2,8,3,19,RV2110c,P9WHT9,88.86296081542969
RVBD0876c:RVBD0876c,8,4,6,1,19,RV0876c,P9WKR5,69.58645629882812
RVBD0685:tuf,6,4,6,3,19,RV0685,P9WNN1,92.80997467041016
RVBD0652:rplL,6,5,4,4,19,RV0652,P9WHE3,75.86776733398438
RVBD1617:pykA,6,4,6,3,19,RV1617,P9WKE5,95.21319580078125
RVBD2109c:prcA,6,4,6,3,19,RV2109c,P9WHU1,90.3600845336914
RVBD0635:hadA,6,5,5,3,19,RV0635,P9WFK1,95.04285430908203
RVBD2610c:pimA,6,3,7,3,19,RV2610c,P9WMZ5,89.7151870727539
RVBD2580c:hisS,6,4,6,3,19,RV2580c,P9WFV5,94.51896667480469
RVBD3804c:fbpA,7,5,5,2,19,RV3804c,P9WQP3,89.94824981689453
RVBD1594:nadA,5,2,8,4,19,RV1594,P9WJK1,93.76455688476562
RVBD2157c:murF,7,5,4,3,19,RV2157c,P9WJL1,92.54534912109375
RVBD1484:inhA,6,3,6,4,19,RV1484,P9WGR1,94.0
RVBD3258c:RVBD3258c,5,3,8,3,19,RV3258c,O53351,72.54901885986328
RVBD0956:purN,4,4,8,3,19,RV0956,P9WHM5,95.50032806396484
RVBD1415:ribA2,7,3,7,2,19,RV1415,P9WHF1,89.57064056396484
RVBD3624c:hpt,5,4,8,2,19,RV3624c,P9WHQ9,89.19059753417969
RVBD3805c:aftB,6,3,5,5,19,RV3805c,O53582,91.0828857421875
RVBD2614c:thrS,5,4,6,3,18,RV2614c,P9WFT5,91.7206802368164
RVBD2244:acpM,7,2,6,3,18,RV2244,P9WQF3,73.60260772705078
RVBD6017:tRNA-Arg18,5,5,6,2,18,RV6017,,
RVBD3604c:RVBD3604c,6,2,7,3,18,RV3604c,O06278,63.04174041748047
RVBD3790:dprE1,6,2,7,3,18,RV3790,P9WJF1,94.78369140625
RVBD2166c:RVBD2166c,5,5,6,2,18,RV2166c,P9WJN9,95.67552185058594
RVBD6013:tRNA-Arg14,6,4,5,3,18,RV6013,,
RVBD3669:RVBD3669,4,4,7,3,18,RV3669,O69637,77.67173767089844
RVBD3044:fecB,6,3,6,3,18,RV3044,O53291,90.83917236328125
RVBD2152c:murC,5,4,6,3,18,RV2152c,P9WJL7,92.01657104492188
RVBD3915:RVBD3915,6,3,5,4,18,RV3915,L7N653,89.58526611328125
RVBD1307:atpH,6,3,7,2,18,RV1307,P9WPV3,91.08497619628906
RVBD3053c:nrdH,7,5,3,3,18,RV3053c,I6YB06,93.54379272460938
RVBD1684:RVBD1684,6,3,6,3,18,RV1684,O33186,86.55377960205078
RVBD2678c:hemE,6,5,5,2,18,RV2678c,P9WFE1,96.76214599609375
RVBD2611c:RVBD2611c,6,3,7,2,18,RV2611c,P9WMB5,87.67794799804688
RVBD1303:RVBD1303,4,5,7,2,18,RV1303,P9WM31,56.38956832885742
RVBD1382:RVBD1382,4,5,6,3,18,RV1382,P71810,91.89485168457031
RVBD0636:hadB,5,4,6,3,18,RV0636,I6WYY7,97.9247055053711
RVBD1380:pyrB,5,3,7,3,18,RV1380,P9WIT7,92.29739379882812
RVBD3917c:parB,6,3,6,3,18,RV3917c,P9WIJ9,75.08700561523438
RVBD0883c:RVBD0883c,6,4,5,3,18,RV0883c,P9WKQ7,82.23217010498047
RVBD2256c:RVBD2256c,5,3,7,3,18,RV2256c,O53530,89.0775146484375
RVBD2245:kasA,5,4,6,3,18,RV2245,P9WQD9,98.49187469482422
RVBD1338:murI,5,4,7,2,18,RV1338,P9WPW9,95.0136947631836
RVBD3580c:cysS1,5,4,6,3,18,RV3580c,P9WFW1,91.97972869873047
RVBD2971:RVBD2971,6,3,6,3,18,RV2971,P9WQA5,96.22371673583984
RVBD2228c:RVBD2228c,7,4,5,2,18,RV2228c,P9WLH5,91.96714782714844
RVBD3029c:fixA,6,3,7,2,18,RV3029c,P9WNG7,95.73352813720703
RVBD2786c:ribF,6,3,6,3,18,RV2786c,I6X5C9,91.90570831298828
RVBD2445c:ndkA,6,3,5,4,18,RV2445c,P9WJH7,97.4306640625
RVBD1406:fmt,7,2,6,3,18,RV1406,P9WND3,95.87234497070312
RVBD3721c:dnaZX,6,4,6,2,18,RV3721c,P9WNT9,82.17963409423828
RVBD3040c:RVBD3040c,6,3,6,3,18,RV3040c,O53287,90.05732727050781
RVBD2754c:thyX,7,3,5,3,18,RV2754c,P9WG57,95.58699798583984
RVBD3030:RVBD3030,5,4,6,3,18,RV3030,P9WJZ1,89.66693878173828
RVBD2539c:aroK,4,3,6,4,17,RV2539c,P9WPY3,91.75273132324219
RVBD0351:grpE,6,2,5,4,17,RV0351,P9WMT5,79.02961730957031
RVBD3581c:ispF,5,4,5,3,17,RV3581c,P9WKG5,96.24188995361328
RVBD3410c:guaB3,5,2,7,3,17,RV3410c,P9WKI5,94.960205078125
RVBD3708c:asd,5,3,6,3,17,RV3708c,P9WNX5,97.02243041992188
RVBD3676:crp,5,4,6,2,17,RV3676,P9WMH3,94.89302825927734
RVBD2246:kasB,5,3,6,3,17,RV2246,P9WQD7,97.5069580078125
RVBD2992c:gltS,4,4,6,3,17,RV2992c,P9WFV9,95.37345123291016
RVBD1208:gpgS,5,3,7,2,17,RV1208,P9WMW9,90.58157348632812
RVBD2518c:ldtB,6,3,6,2,17,RV2518c,I6Y9J2,91.45507049560547
RVBD1024:RVBD1024,5,3,6,3,17,RV1024,P96376,68.61890411376953
RVBD1822:pgsA2,7,2,7,1,17,RV1822,P9WPG5,84.16632080078125
RVBD1086:RVBD1086,6,3,6,2,17,RV1086,P9WFF5,92.33045959472656
RVBD1462:RVBD1462,5,2,6,4,17,RV1462,P9WFP5,93.3070297241211
RVBD1379:pyrR,4,4,7,2,17,RV1379,P9WHK3,92.36927032470703
RVBD2540c:aroF,6,3,5,3,17,RV2540c,P9WPY1,95.06243896484375
RVBD1440:secG,5,2,7,3,17,RV1440,P9WGN5,64.01844024658203
RVBD2523c:acpS,6,4,7,0,17,RV2523c,P9WQD3,87.775390625
RVBD3411c:guaB2,5,2,7,3,17,RV3411c,P9WKI7,89.29405975341797
RVBD3303c:lpdA,4,4,6,3,17,RV3303c,P9WHH7,93.032958984375
RVBD0772:purD,6,2,7,2,17,RV0772,P9WHM9,96.36894989013672
RVBD1229c:mrp,6,2,8,1,17,RV1229c,P9WJN7,87.89097595214844
RVBD1613:trpA,5,3,6,3,17,RV1613,P9WFY1,92.86014556884766
RVBD0004:RVBD0004,5,3,7,2,17,RV0004,P9WFL1,76.82122802734375
RVBD0949:uvrD1,5,5,6,1,17,RV0949,P9WMQ1,86.9735336303711
RVBD0016c:pbpA,6,2,7,2,17,RV0016c,P9WKD1,94.5440902709961
RVBD6040:tRNA-Met38,5,4,6,2,17,RV6040,,
RVBD0020c:fhaA,5,3,6,3,17,RV0020c,P71590,60.45213317871094
RVBD2094c:tatA,4,3,8,2,17,RV2094c,P9WGA1,76.03639221191406
RVBD3372:otsB2,5,2,8,2,17,RV3372,P9WFZ5,92.75811004638672
RVBD2837c:RVBD2837c,6,4,5,2,17,RV2837c,P71615,92.86544036865234
RVBD3227:aroA,5,3,7,2,17,RV3227,P9WPY5,93.6112289428711
RVBD2440c:obg,6,3,6,2,17,RV2440c,P9WMT1,78.9259033203125
RVBD3458c:rpsD,4,6,5,2,17,RV3458c,P9WH35,92.12919616699219
RVBD0707:rpsC,6,4,4,3,17,RV0707,P9WH37,81.78781127929688
RVBD2121c:hisG,5,2,7,3,17,RV2121c,P9WMN1,95.24736022949219
RVBD6038:tRNA-Gln36,6,2,7,2,17,RV6038,,
RVBD0710:rpsQ,6,3,5,3,17,RV0710,P9WH51,80.49266815185547
RVBD0684:fusA1,5,3,6,3,17,RV0684,P9WNM7,85.19548797607422
RVBD1408:rpe,6,3,5,3,17,RV1408,P9WI51,96.2762451171875
RVBD3792:aftA,7,2,5,3,17,RV3792,P9WN03,93.84220886230469
RVBD3807c:RVBD3807c,5,2,6,4,17,RV3807c,P9WI53,94.31163787841797
RVBD3035:RVBD3035,6,2,6,3,17,RV3035,I6XFZ8,95.16927337646484
RVBD0236c:aftD,6,2,6,3,17,RV0236c,P96419,93.27384185791016
RVBD0777:purB,4,4,6,3,17,RV0777,I6XWA1,95.1442642211914
RVBD0993:galU,6,2,6,3,17,RV0993,O05576,93.9951400756836
RVBD2439c:proB,6,2,7,2,17,RV2439c,P9WHU9,89.55545806884766
RVBD0721:rpsE,5,5,4,3,17,RV0721,P9WH33,85.40827178955078
RVBD0282:eccA3,6,2,5,4,17,RV0282,P9WPI3,89.23902893066406
RVBD0286:PPE4,6,2,6,3,17,RV0286,P9WI43,67.1328125
RVBD0350:dnaK,6,2,7,2,17,RV0350,P9WMJ9,87.69035339355469
RVBD3921c:RVBD3921c,7,3,6,1,17,RV3921c,P9WIT5,81.83169555664062
RVBD2421c:nadD,4,4,7,2,17,RV2421c,P9WJJ5,84.823974609375
RVBD0705:rpsS,5,3,5,3,16,RV0705,P9WH45,88.0079574584961
RVBD1609:trpE,6,2,5,3,16,RV1609,P9WFX3,94.84288787841797
RVBD3221c:TB7.3,6,3,5,2,16,RV3221c,P9WPQ1,95.87338256835938
RVBD6042:tRNA-Pro40,5,4,5,2,16,RV6042,,
RVBD3193c:RVBD3193c,6,3,4,3,16,RV3193c,P9WFL3,89.46382904052734
RVBD2538c:aroB,5,2,7,2,16,RV2538c,P9WPX9,94.36861419677734
RVBD3814c:RVBD3814c,5,5,4,2,16,RV3814c,O07809,89.17977905273438
RVBD1539:lspA,6,4,4,2,16,RV1539,P9WK99,84.03856658935547
RVBD2111c:pup,6,2,6,2,16,RV2111c,P9WHN5,81.48875427246094
RVBD3608c:folP1,5,3,5,3,16,RV3608c,P9WND1,90.53146362304688
RVBD1327c:glgE,6,2,6,2,16,RV1327c,P9WQ17,94.27061462402344
RVBD3256c:RVBD3256c,5,3,6,2,16,RV3256c,O05899,91.58595275878906
RVBD2881c:cdsA,6,2,5,3,16,RV2881c,P9WPF7,81.4462890625
RVBD2553c:RVBD2553c,6,2,6,2,16,RV2553c,I6XEK6,87.30776977539062
RVBD3791:dprE2,6,3,5,2,16,RV3791,P9WGS9,95.2834243774414
RVBD2155c:murD,5,2,6,3,16,RV2155c,P9WJL5,91.29251861572266
RVBD2548A:RVBD2548A,4,4,6,2,16,RV2548A,I6XEK2,96.68257141113281
RVBD1248c:RVBD1248c,6,3,6,1,16,RV1248c,P9WIS5,89.89360809326172
RVBD0207c:RVBD0207c,6,3,5,2,16,RV0207c,P96389,83.49610900878906
RVBD1650:pheT,4,2,7,3,16,RV1650,P9WFU1,93.85919952392578
RVBD6024:tRNA-Leu22,6,3,4,3,16,RV6024,,
RVBD3275c:purE,5,3,6,2,16,RV3275c,P9WHM1,96.41239929199219
RVBD0957:purH,5,3,6,2,16,RV0957,P9WHM7,96.20999908447266
RVBD0283:eccB3,6,2,5,3,16,RV0283,P9WNR3,85.44317626953125
RVBD3276c:purK,6,3,5,2,16,RV3276c,P9WHL9,91.65120697021484
RVBD0003:recF,7,2,5,2,16,RV0003,P9WHI9,93.29007720947266
RVBD2613c:RVBD2613c,5,2,7,2,16,RV2613c,P9WMK9,80.4026107788086
RVBD3418c:groES,5,3,6,2,16,RV3418c,P9WPE5,91.63619232177734
RVBD2795c:RVBD2795c,6,2,6,2,16,RV2795c,I6YEE1,93.90709686279297
RVBD2207:cobT,4,3,7,2,16,RV2207,P9WP85,94.86847686767578
RVBD0041:leuS,5,3,5,3,16,RV0041,P9WFV1,91.03549194335938
RVBD1017c:prsA,5,4,5,2,16,RV1017c,P9WKE3,92.64070892333984
RVBD3034c:RVBD3034c,5,3,5,3,16,RV3034c,O53281,84.10836791992188
RVBD2247:accD6,5,2,6,3,16,RV2247,P9WQH5,94.89765930175781
RVBD1292:argS,5,4,5,2,16,RV1292,P9WFW5,94.84158325195312
RVBD6002:tRNA-Leu3,5,3,6,2,16,RV6002,,
RVBD2122c:hisE,3,4,7,2,16,RV2122c,P9WMM9,95.39021301269531
RVBD6009:tRNA-Lys10,5,4,3,4,16,RV6009,,
RVBD0057:RVBD0057,7,3,5,1,16,RV0057,P9WM77,33.60121154785156
RVBD6037:tRNA-Glu35,5,3,6,2,16,RV6037,,
RVBD2169c:RVBD2169c,6,3,5,2,16,RV2169c,O53503,64.74380493164062
RVBD2996c:serA1,5,3,5,3,16,RV2996c,P9WNX3,94.95630645751953
RVBD2448c:valS,5,3,5,3,16,RV2448c,P9WFS9,93.02667236328125
RVBD3301c:phoY1,5,4,5,2,16,RV3301c,P9WI97,94.14995574951172
RVBD2868c:gcpE,5,3,6,2,16,RV2868c,P9WKG3,90.61400604248047
RVBD2220:glnA1,5,2,7,2,16,RV2220,P9WN39,95.01725769042969
RVBD1343c:lprD,5,3,5,3,16,RV1343c,P9WK51,84.85159301757812
RVBD0289:espG3,6,4,5,1,16,RV0289,P9WJC7,88.04749298095703
RVBD2764c:thyA,6,3,6,1,16,RV2764c,P9WFR9,97.46601104736328
RVBD3634c:galE1,6,2,6,2,16,RV3634c,P9WN67,95.94647216796875
RVBD2401A:RVBD2401A,5,3,6,2,16,RV2401A,Q79FE4,89.10971069335938
RVBD1630:rpsA,6,3,4,3,16,RV1630,P9WH43,70.91667938232422
RVBD2869c:rip,5,4,5,2,16,RV2869c,P9WHS3,90.84052276611328
RVBD2753c:dapA,4,4,6,2,16,RV2753c,P9WP25,97.82624053955078
RVBD0410c:pknG,7,2,4,3,16,RV0410c,P9WI73,87.078857421875
RVBD3247c:tmk,6,2,5,3,16,RV3247c,P9WKE1,95.39620971679688
RVBD3858c:gltD,5,3,5,3,16,RV3858c,P9WN19,96.2729721069336
RVBD3264c:manB,5,2,6,3,16,RV3264c,L7N6A5,95.80473327636719
RVBD2593c:ruvA,7,3,4,2,16,RV2593c,P9WGW3,90.34259033203125
RVBD2215:dlaT,6,3,5,2,16,RV2215,P9WIS7,81.80072021484375
RVBD0723:rplO,6,4,5,1,16,RV0723,P9WHD7,95.45999908447266
RVBD3255c:manA,6,2,6,1,15,RV3255c,O05898,96.4179916381836
RVBD0046c:ino1,4,4,5,2,15,RV0046c,P9WKI1,92.50005340576172
RVBD2883c:pyrH,7,2,5,1,15,RV2883c,P9WHK5,88.24666595458984
RVBD0640:rplK,4,4,5,2,15,RV0640,P9WHE5,82.99337768554688
RVBD2842c:RVBD2842c,6,3,5,1,15,RV2842c,P9WH17,85.2814712524414
RVBD0226c:RVBD0226c,6,2,4,3,15,RV0226c,P96408,93.42340850830078
RVBD2979c:RVBD2979c,6,3,5,1,15,RV2979c,I6XFU1,86.34979248046875
RVBD3356c:folD,6,3,4,2,15,RV3356c,P9WG81,97.04772186279297
RVBD1449c:tkt,5,3,5,2,15,RV1449c,P9WG25,97.25387573242188
RVBD2367c:RVBD2367c,7,2,6,0,15,RV2367c,P9WGX9,89.91767883300781
RVBD0706:rplV,6,2,5,2,15,RV0706,P9WHC1,77.47061157226562
RVBD3722c:RVBD3722c,5,2,5,3,15,RV3722c,O69689,96.92684936523438
RVBD6003:tRNA-Gly4,7,2,5,1,15,RV6003,,
RVBD0284:eccC3,6,2,5,2,15,RV0284,P9WNA9,84.60286712646484
RVBD0290:eccD3,6,2,4,3,15,RV0290,P9WNQ3,88.65995788574219
RVBD1612:trpB,5,2,6,2,15,RV1612,P9WFX9,95.20564270019531
RVBD2153c:murG,4,3,6,2,15,RV2153c,P9WJK9,87.5529556274414
RVBD1782:eccB5,6,1,5,3,15,RV1782,P9WNQ9,88.7861099243164
RVBD6041:tRNA-Thr39,7,2,4,2,15,RV6041,,
RVBD2516c:RVBD2516c,6,2,5,2,15,RV2516c,I6YDM0,81.17794036865234
RVBD3610c:ftsH,4,3,6,2,15,RV3610c,P9WQN3,79.21549987792969
RVBD1695:ppnK,4,2,6,3,15,RV1695,P9WHV7,88.39557647705078
RVBD1315:murA,5,3,5,2,15,RV1315,P9WJM1,96.79081726074219
RVBD1018c:glmU,5,3,5,2,15,RV1018c,P9WMN3,94.93152618408203
RVBD1177:fdxC,5,2,5,3,15,RV1177,O50433,96.19693756103516
RVBD0189c:ilvD,3,3,6,3,15,RV0189c,P9WKJ5,94.18090057373047
RVBD0505c:serB1,6,2,6,1,15,RV0505c,P9WGJ3,81.720947265625
RVBD0531:RVBD0531,5,3,6,1,15,RV0531,O06397,75.732666015625
RVBD2192c:trpD,5,2,7,1,15,RV2192c,P9WFX5,92.33659362792969
RVBD2909c:rpsP,6,4,3,2,15,RV2909c,P9WH53,76.44802856445312
RVBD0180c:RVBD0180c,5,2,8,0,15,RV0180c,O07424,88.27716827392578
RVBD1378c:RVBD1378c,5,3,5,2,15,RV1378c,P71806,82.82705688476562
RVBD1649:pheS,5,2,5,3,15,RV1649,P9WFU3,94.06656646728516
RVBD0796:RVBD0796,7,2,5,1,15,RV0796,P9WKH9,87.83438110351562
RVBD2204c:RVBD2204c,5,2,6,2,15,RV2204c,P9WMN5,76.5064468383789
RVBD1689:tyrS,6,2,5,2,15,RV1689,P9WFT1,92.58184814453125
RVBD2219:RVBD2219,6,2,4,3,15,RV2219,P9WLI1,79.69984436035156
RVBD6018:16S,5,4,4,2,15,RV6018,,
RVBD2112c:dop,6,2,5,2,15,RV2112c,P9WNU9,93.82609558105469
RVBD0952:sucD,6,2,7,0,15,RV0952,P9WGC7,95.06055450439453
RVBD2199c:RVBD2199c,5,3,6,1,15,RV2199c,P9WP45,96.02064514160156
RVBD0704:rplB,5,4,5,1,15,RV0704,P9WHA5,95.4664306640625
RVBD1099c:glpX,5,2,5,2,14,RV1099c,P9WN21,89.68354034423828
RVBD0479c:RVBD0479c,5,2,6,1,14,RV0479c,P9WKV7,73.41758728027344
RVBD2477c:RVBD2477c,5,3,4,2,14,RV2477c,P9WQK3,88.33991241455078
RVBD3780:RVBD3780,3,5,5,1,14,RV3780,P9WKX3,82.30195617675781
RVBD2697c:dut,5,2,6,1,14,RV2697c,P9WNS5,98.04207611083984
RVBD2984:ppk1,6,2,4,2,14,RV2984,P9WHV9,88.21963500976562
RVBD3210c:RVBD3210c,6,2,5,1,14,RV3210c,O05856,87.45540618896484
RVBD0524:hemL,5,2,5,2,14,RV0524,P9WMN9,92.07371520996094
RVBD1392:metK,5,2,5,2,14,RV1392,P9WGV1,95.08700561523438
RVBD0164:TB18.5,6,2,5,1,14,RV0164,L7N657,91.0622329711914
RVBD0955:RVBD0955,6,2,4,2,14,RV0955,P9WKN3,86.47560119628906
RVBD0017c:rodA,6,2,4,2,14,RV0017c,P9WN99,88.70537567138672
RVBD3042c:serB2,5,2,6,1,14,RV3042c,O53289,93.9333267211914
RVBD3712:RVBD3712,6,2,4,2,14,RV3712,I6Y4C7,92.1475830078125
RVBD2839c:infB,4,4,4,2,14,RV2839c,P9WKK1,74.31056213378906
RVBD0896:gltA2,4,2,6,2,14,RV0896,P9WPD5,93.44050598144531
RVBD2154c:ftsW,7,2,4,1,14,RV2154c,P9WN97,79.8675765991211
RVBD0719:rplF,5,2,5,2,14,RV0719,P9WH81,93.33453369140625
RVBD0352:dnaJ1,5,2,6,1,14,RV0352,P9WNV9,83.47979736328125
RVBD1565c:RVBD1565c,5,3,4,2,14,RV1565c,O06625,88.2289047241211
RVBD0647c:RVBD0647c,5,3,4,2,14,RV0647c,P9WQI1,76.26395416259766
RVBD1301:RVBD1301,4,3,6,1,14,RV1301,P9WGC9,96.1131820678711
RVBD2507:RVBD2507,6,3,4,1,14,RV2507,O06170,69.94702911376953
RVBD2699c:RVBD2699c,6,3,4,1,14,RV2699c,I6YA17,78.44740295410156
RVBD1694:tlyA,5,2,4,3,14,RV1694,P9WJ63,93.53123474121094
RVBD3125c:PPE49,6,2,4,2,14,RV3125c,P9WHY5,69.32218170166016
RVBD3673c:RVBD3673c,5,3,6,0,14,RV3673c,I6YGW6,88.58616638183594
RVBD1384:carB,5,2,6,1,14,RV1384,P9WPK3,92.4256591796875
RVBD3672c:RVBD3672c,6,2,4,2,14,RV3672c,I6XHX8,84.42652893066406
RVBD2173:idsA2,6,3,4,1,14,RV2173,O53507,95.6333236694336
RVBD6014:tRNA-Ala15,5,3,5,1,14,RV6014,,
RVBD1093:glyA1,5,2,6,1,14,RV1093,P9WGI9,97.4386978149414
RVBD2843:RVBD2843,6,2,4,2,14,RV2843,I6YAE2,78.62983703613281
RVBD3423c:alr,6,2,4,2,14,RV3423c,P9WQA9,95.85572052001953
RVBD1710:scpB,5,2,5,2,14,RV1710,I6XCB2,81.07048034667969
RVBD6036:tRNA-Val34,5,4,4,1,14,RV6036,,
RVBD2008c:RVBD2008c,5,3,4,2,14,RV2008c,P9WLM9,85.3612060546875
RVBD0718:rpsH,4,3,4,3,14,RV0718,P9WH27,95.97856140136719
RVBD0127:mak,6,4,4,0,14,RV0127,O07177,92.31707763671875
RVBD2908c:RVBD2908c,6,3,5,0,14,RV2908c,P9WFM7,93.04661560058594
RVBD2218:lipA,6,2,4,2,14,RV2218,P9WK91,91.89665222167969
RVBD1459c:RVBD1459c,4,3,5,2,14,RV1459c,O53150,85.65876770019531
RVBD1299:prfA,6,2,5,1,14,RV1299,P9WHG3,87.99761962890625
RVBD3846:sodA,6,2,6,0,14,RV3846,P9WGE7,97.6938705444336
RVBD1348:irtA,5,2,4,3,14,RV1348,P9WQJ9,84.3729019165039
RVBD2594c:ruvC,6,3,4,1,14,RV2594c,P9WGV9,93.71314239501953
RVBD3105c:prfB,5,2,4,3,14,RV3105c,P9WHG1,88.61746215820312
RVBD6008:tRNA-Thr9,4,2,5,3,14,RV6008,,
RVBD1713:engA,5,2,5,2,14,RV1713,P9WNL3,77.69004821777344
RVBD2965c:kdtB,4,2,6,2,14,RV2965c,P9WPA5,94.94111633300781
RVBD3626c:RVBD3626c,7,2,5,0,14,RV3626c,O06381,82.49285888671875
RVBD2115c:mpa,4,3,6,1,14,RV2115c,P9WQN5,82.73016357421875
RVBD0528:RVBD0528,6,2,4,2,14,RV0528,O06394,89.64299011230469
RVBD3253c:RVBD3253c,5,3,4,1,13,RV3253c,O05896,85.98871612548828
RVBD1699:pyrG,4,2,4,3,13,RV1699,P9WHK7,90.56704711914062
RVBD2993c:RVBD2993c,5,2,5,1,13,RV2993c,I6Y276,96.0177001953125
RVBD3137:RVBD3137,5,2,5,1,13,RV3137,P95189,96.648193359375
RVBD2520c:RVBD2520c,5,3,4,1,13,RV2520c,I6XEI0,77.25506591796875
RVBD1831:RVBD1831,6,2,4,1,13,RV1831,P9WLR3,59.717647552490234
RVBD6035:tRNA-Cys33,5,2,4,2,13,RV6035,,
RVBD3031:RVBD3031,5,3,4,1,13,RV3031,P9WQ27,96.07026672363281
RVBD1837c:glcB,6,2,4,1,13,RV1837c,P9WK17,95.85420989990234
RVBD3910:RVBD3910,4,3,4,2,13,RV3910,P9WJK3,76.3135757446289
RVBD3012c:gatC,4,3,4,2,13,RV3012c,P9WN59,92.48079681396484
RVBD0047c:RVBD0047c,6,2,3,2,13,RV0047c,P71704,88.65016174316406
RVBD0495c:RVBD0495c,6,2,4,1,13,RV0495c,P9WKU5,87.685546875
RVBD1388:mihF,4,2,5,2,13,RV1388,P71658,71.75990295410156
RVBD1055:RVBD1055,4,4,5,0,13,RV1055,O53403,71.9093246459961
RVBD3443c:rplM,4,3,4,2,13,RV3443c,P9WHE1,93.63034057617188
RVBD3838c:pheA,5,2,5,1,13,RV3838c,P9WIC3,91.74358367919922
RVBD2163c:pbpB,6,1,4,2,13,RV2163c,L0T911,87.78582763671875
RVBD1222:rseA,5,2,4,2,13,RV1222,L0T905,73.60012817382812
RVBD0347:RVBD0347,5,2,4,2,13,RV0347,O06298,80.73493194580078
RVBD2178c:aroG,3,3,5,2,13,RV2178c,O53512,94.87674713134766
RVBD1221:sigE,5,2,4,2,13,RV1221,P9WGG7,75.05972290039062
RVBD3102c:ftsE,4,3,5,1,13,RV3102c,O05779,94.62274169921875
RVBD3753c:RVBD3753c,6,2,5,0,13,RV3753c,O69720,93.82752227783203
RVBD6046:tRNA-Ser44,5,2,4,2,13,RV6046,,
RVBD0702:rplD,4,2,4,3,13,RV0702,P9WH85,91.0502700805664
RVBD0453:PPE11,6,2,4,1,13,RV0453,P9WI39,69.51334381103516
RVBD2206:RVBD2206,5,3,4,1,13,RV2206,P9WLI5,75.64474487304688
RVBD3489:RVBD3489,5,2,6,0,13,RV3489,I6YC91,78.7518539428711
RVBD0700:rpsJ,6,3,4,0,13,RV0700,P9WH67,89.02960968017578
RVBD0637:hadC,6,1,4,2,13,RV0637,P9WFJ9,92.16554260253906
RVBD6000:tRNA-Ile1,5,1,5,2,13,RV6000,,
RVBD3754:tyrA,5,3,4,1,13,RV3754,O69721,95.28306579589844
RVBD3609c:folE,4,2,5,2,13,RV3609c,P9WN57,93.60589599609375
RVBD1712:cmk,6,2,4,1,13,RV1712,P9WPA9,93.07782745361328
RVBD3510c:RVBD3510c,6,2,4,1,13,RV3510c,I6Y3Q7,94.87935638427734
RVBD0849:RVBD0849,6,2,4,1,13,RV0849,P9WJX5,89.39450073242188
RVBD2343c:dnaG,5,2,4,2,13,RV2343c,P9WNW1,85.56011199951172
RVBD1604:impA,6,1,4,2,13,RV1604,O53907,94.00814819335938
RVBD1825:RVBD1825,3,2,5,3,13,RV1825,P9WFG3,80.13684844970703
RVBD6047:tRNA-Ser45,4,2,5,2,13,RV6047,,
RVBD1602:hisH,4,2,5,2,13,RV1602,P9WMM1,97.38558197021484
RVBD0542c:menE,6,2,4,1,13,RV0542c,P9WQ39,91.1616439819336
RVBD3665c:dppB,5,3,4,1,13,RV3665c,I6YGV9,89.03483581542969
RVBD1300:hemK,3,3,5,2,13,RV1300,P9WHV3,91.3375015258789
RVBD3670:ephE,5,3,4,1,13,RV3670,I6YCQ4,93.38055419921875
RVBD3346c:RVBD3346c,5,3,4,1,13,RV3346c,O50377,90.73846435546875
RVBD0709:rpmC,5,2,4,2,13,RV0709,P9WHA7,86.68948364257812
RVBD3924c:rpmH,4,2,5,2,13,RV3924c,P9WH93,94.7672348022461
RVBD3601c:panD,5,2,6,0,13,RV3601c,P9WIL3,94.62165832519531
RVBD0809:purM,4,3,5,1,13,RV0809,I6Y4V6,93.95761108398438
RVBD1130:prpD,4,3,3,3,13,RV1130,O06582,94.05256652832031
RVBD1240:mdh,5,2,5,1,13,RV1240,P9WK13,96.98628997802734
RVBD0642c:mmaA4,4,2,5,2,13,RV0642c,Q79FX8,93.25318908691406
RVBD3100c:smpB,6,2,4,1,13,RV3100c,P9WGD3,89.26325988769531
RVBD1411c:lprG,4,3,5,1,13,RV1411c,P9WK45,90.6203384399414
RVBD2230c:RVBD2230c,6,2,4,1,13,RV2230c,P9WFM1,95.04454803466797
RVBD0510:hemC,5,2,5,1,13,RV0510,P9WMP3,92.9524917602539
RVBD3916c:RVBD3916c,4,3,4,2,13,RV3916c,O53594,84.26983642578125
RVBD0334:rmlA,4,3,4,2,13,RV0334,P9WH13,95.36580657958984
RVBD1294:thrA,4,3,4,2,13,RV1294,P9WPX1,94.54886627197266
RVBD0011c:RVBD0011c,6,2,4,1,13,RV0011c,P9WP57,66.74010467529297
RVBD0455c:RVBD0455c,4,2,5,2,13,RV0455c,O53740,87.51398468017578
RVBD2552c:aroE,4,2,5,2,13,RV2552c,I6Y120,96.53720092773438
RVBD0412c:RVBD0412c,6,2,4,1,13,RV0412c,P96258,76.1568374633789
RVBD1461:RVBD1461,3,2,6,2,13,RV1461,P9WFP7,81.39869689941406
RVBD0720:rplR,4,2,6,1,13,RV0720,P9WHD1,96.08303833007812
RVBD1464:csd,4,2,6,1,13,RV1464,P9WQ69,96.23237609863281
RVBD2465c:rpiB,4,2,6,1,13,RV2465c,P9WKD7,97.48815155029297
RVBD0787A:RVBD0787A,7,2,4,0,13,RV0787A,I6Y8S6,95.93961334228516
RVBD2202c:adoK,5,2,6,0,13,RV2202c,P9WID5,96.7822265625
RVBD3266c:rmlD,4,2,6,1,13,RV3266c,P9WH09,93.24601745605469
RVBD1836c:RVBD1836c,5,1,6,1,13,RV1836c,P9WLQ9,80.57280731201172
RVBD2441c:rpmA,4,4,4,1,13,RV2441c,P9WHB3,88.74813079833984
RVBD1401:RVBD1401,5,2,5,1,13,RV1401,P9WG51,87.30743408203125
RVBD2978c:RVBD2978c,4,3,5,1,13,RV2978c,I6Y263,86.46205139160156
RVBD2970A:RVBD2970A,5,1,4,3,13,RV2970A,I6XFT2,80.15553283691406
RVBD6012:tRNA-Phe13,5,2,6,0,13,RV6012,,
RVBD1600:hisC1,4,2,5,1,12,RV1600,P9WML7,94.59021759033203
RVBD2664:RVBD2664,4,2,5,1,12,RV2664,I6Y9Z5,89.44083404541016
RVBD1293:lysA,3,2,5,2,12,RV1293,P9WIU7,97.16044616699219
RVBD3635:RVBD3635,5,2,4,1,12,RV3635,I6Y460,95.40122985839844
RVBD2149c:yfiH,5,2,4,1,12,RV2149c,P9WKD5,94.94060516357422
RVBD0795:RVBD0795,7,2,3,0,12,RV0795,P9WKH5,91.50304412841797
RVBD0294:tam,5,2,4,1,12,RV0294,P9WGA3,92.27279663085938
RVBD3464:rmlB,3,2,4,3,12,RV3464,P9WN65,97.21797943115234
RVBD1536:ileS,5,2,3,2,12,RV1536,P9WFV3,92.51924133300781
4.5S:4.5S,5,2,5,0,12,4.,P60372,
RVBD0562:grcC1,6,2,4,0,12,RV0562,O06428,92.01507568359375
RVBD1402:priA,5,2,5,0,12,RV1402,P9WMQ9,89.61251831054688
RVBD1634:RVBD1634,6,2,4,0,12,RV1634,P9WJX3,86.40585327148438
RVBD1437:pgk,4,2,4,2,12,RV1437,P9WID1,94.62609100341797
RVBD1661:pks7,5,2,4,1,12,RV1661,P94996,85.70660400390625
RVBD0803:purL,3,3,5,1,12,RV0803,P9WHL7,92.86279296875
RVBD2903c:lepB,5,2,4,1,12,RV2903c,P9WKA1,82.80592346191406
RVBD3627c:RVBD3627c,4,3,4,1,12,RV3627c,O06380,92.4099349975586
RVBD3863:RVBD3863,5,2,4,1,12,RV3863,P96214,74.21372985839844
RVBD6034:tRNA-Gly32,4,3,4,1,12,RV6034,,
RVBD1633:uvrB,5,2,4,1,12,RV1633,P9WFC7,85.51834869384766
RVBD3531c:RVBD3531c,5,2,4,1,12,RV3531c,I6XHH2,95.37300872802734
RVBD0544c:RVBD0544c,4,3,4,1,12,RV0544c,O06410,86.27510833740234
RVBD0788:purQ,3,3,4,2,12,RV0788,P9WHL5,96.71299743652344
RVBD0843:RVBD0843,5,3,4,0,12,RV0843,I6XWE5,83.88694763183594
RVBD3378c:RVBD3378c,3,2,6,1,12,RV3378c,P9WJ61,93.6002426147461
RVBD3682:ponA2,6,2,2,2,12,RV3682,I6YGX2,89.72999572753906
RVBD0291:mycP3,6,2,4,0,12,RV0291,O53695,88.17595672607422
RVBD1456c:RVBD1456c,3,3,4,2,12,RV1456c,O53148,94.72818756103516
RVBD0929:pstC2,5,3,3,1,12,RV0929,P9WG05,90.08740997314453
RVBD1826:gcvH,6,2,4,0,12,RV1826,P9WN55,96.11485290527344
RVBD0954:RVBD0954,6,1,5,0,12,RV0954,P9WIR9,60.39524841308594
RVBD2904c:rplS,5,1,4,2,12,RV2904c,P9WHC9,95.22575378417969
RVBD6021:tRNA-Leu19,4,4,4,0,12,RV6021,,
RVBD1234:RVBD1234,6,2,4,0,12,RV1234,O50451,83.43897247314453
RVBD0879c:RVBD0879c,5,2,4,1,12,RV0879c,P9WKR1,86.74868774414062
RVBD3207c:RVBD3207c,6,1,4,1,12,RV3207c,O05859,87.65115356445312
RVBD0683:rpsG,5,1,4,2,12,RV0683,P9WH29,94.75749969482422
RVBD2135c:RVBD2135c,6,2,4,0,12,RV2135c,O06240,91.54788208007812
RVBD2870c:dxr,4,2,4,2,12,RV2870c,P9WNS1,92.38016510009766
RVBD1337:RVBD1337,6,2,4,0,12,RV1337,P9WM21,90.55204772949219
RVBD0699:RVBD0699,6,2,4,0,12,RV0699,P95046,51.74602508544922
RVBD2899c:fdhD,6,2,4,0,12,RV2899c,P9WNF1,89.51395416259766
RVBD2188c:pimB,5,2,4,1,12,RV2188c,P9WMZ3,95.20986938476562
RVBD0746:PE-PGRS9,6,2,4,0,12,RV0746,Q79FW8,92.91806030273438
RVBD2190c:RVBD2190c,6,0,4,2,12,RV2190c,P9WHU3,81.70903778076172
RVBD2676c:RVBD2676c,3,2,5,2,12,RV2676c,P9WL45,97.34294128417969
RVBD3715c:recR,6,1,4,1,12,RV3715c,P9WHI3,94.25531005859375
RVBD3236c:RVBD3236c,4,2,4,2,12,RV3236c,L7N665,88.04641723632812
RVBD3011c:gatA,4,2,5,1,12,RV3011c,P9WQA1,96.95536041259766
RVBD3082c:virS,6,2,4,0,12,RV3082c,P9WMJ3,88.65776824951172
RVBD1015c:rplY,6,2,4,0,12,RV1015c,P9WHB5,83.74618530273438
RVBD3456c:rplQ,4,2,4,2,12,RV3456c,P9WHD3,82.12361145019531
RVBD1037c:esxI,6,2,4,0,12,RV1037c,P0DOA6,94.30178833007812
RVBD3602c:panC,5,2,5,0,12,RV3602c,P9WIL5,92.8966293334961
RVBD2838c:rbfA,6,2,4,0,12,RV2838c,P9WHJ7,79.69393920898438
RVBD0163:RVBD0163,5,2,5,0,12,RV0163,O07408,94.8476791381836
RVBD0555:menD,5,2,4,1,12,RV0555,P9WK11,94.69810485839844
RVBD3663c:dppD,5,2,5,0,12,RV3663c,I6Y482,88.45580291748047
RVBD3644c:RVBD3644c,5,2,4,1,12,RV3644c,O06363,91.23085021972656
RVBD1631:coaE,3,4,4,1,12,RV1631,P9WPA3,94.94544982910156
RVBD3039c:echA17,5,2,5,0,12,RV3039c,P9WNN3,94.67620849609375
RVBD1832:gcvB,5,2,4,1,12,RV1832,P9WN53,96.58848571777344
RVBD0979c:RVBD0979c,4,2,6,0,12,RV0979c,O53892,44.03359603881836
RVBD6015:tRNA-Gln16,4,2,5,1,12,RV6015,,
RVBD0951:sucC,4,2,5,1,12,RV0951,P9WGC5,94.67056274414062
RVBD3133c:devR,6,2,4,0,12,RV3133c,P9WMF9,83.7173843383789
RVBD1845c:blaR,6,1,3,2,12,RV1845c,P95164,82.93427276611328
RVBD0411c:glnH,5,2,4,1,12,RV0411c,P96257,91.31912231445312
RVBD0998:RVBD0998,4,2,5,1,12,RV0998,O05581,90.17288208007812
RVBD1211:RVBD1211,4,2,4,2,12,RV1211,O05312,82.32653045654297
RVBD2726c:dapF,4,3,4,1,12,RV2726c,P9WP19,96.64539337158203
RVBD6022:tRNA-Leu20,4,1,6,1,12,RV6022,,
RVBD1416:ribH,5,2,4,1,12,RV1416,P9WHE9,95.1241226196289
RVBD1383:carA,3,3,5,1,12,RV1383,P9WPK5,96.91260528564453
RVBD1657:argR,5,2,4,1,12,RV1657,P9WPY9,85.71883392333984
RVBD2235:RVBD2235,4,3,4,1,12,RV2235,P9WGA7,87.72454071044922
RVBD2844:RVBD2844,5,1,5,1,12,RV2844,I6Y1V1,88.6649398803711
RVBD1641:infC,4,2,4,2,12,RV1641,P9WKJ9,82.47616577148438
RVBD3434c:RVBD3434c,5,2,5,0,12,RV3434c,I6YC44,81.14995574951172
RVBD2158c:murE,2,4,4,2,12,RV2158c,P9WJL3,91.58558654785156
RVBD0287:esxG,6,2,4,0,12,RV0287,O53692,84.5430908203125
RVBD3313c:add,6,2,4,0,12,RV3313c,P63907,97.1087646484375
RVBD1295:thrC,4,2,4,2,12,RV1295,P9WG59,95.09741973876953
RVBD6033:tRNA-Val31,5,2,4,0,11,RV6033,,
RVBD1092c:coaA,5,2,4,0,11,RV1092c,P9WPA7,91.97711181640625
RVBD3163c:RVBD3163c,5,2,4,0,11,RV3163c,O53313,86.23368835449219
RVBD1658:argG,4,2,4,1,11,RV1658,P9WPW7,96.58340454101562
RVBD0101:nrp,4,2,4,1,11,RV0101,Q10896,68.14566040039062
RVBD3919c:gid,5,2,4,0,11,RV3919c,P9WGW9,91.88848114013672
RVBD0409:ackA,5,2,4,0,11,RV0409,P9WQH1,95.26292419433594
RVBD0090:RVBD0090,5,2,4,0,11,RV0090,P9WM71,88.24514770507812
RVBD0693:pqqE,4,3,4,0,11,RV0693,P9WJ79,89.73605346679688
RVBD3281:accE5,5,2,4,0,11,RV3281,P96886,55.77875518798828
RVBD3704c:gshA,5,2,4,0,11,RV3704c,P9WPK7,93.56259155273438
RVBD3473c:bpoA,5,2,3,1,11,RV3473c,O06338,93.72046661376953
RVBD0541c:RVBD0541c,4,2,2,3,11,RV0541c,O06407,95.26612854003906
RVBD1623c:cydA,5,2,4,0,11,RV1623c,L7N662,90.80393981933594
RVBD2825c:RVBD2825c,6,2,3,0,11,RV2825c,P71627,83.37841796875
RVBD3468c:RVBD3468c,4,2,4,1,11,RV3468c,Q6MWX3,88.62870025634766
RVBD3628:ppa,4,2,4,1,11,RV3628,P9WI55,96.50074005126953
RVBD0123:RVBD0123,5,2,3,1,11,RV0123,O07173,82.41212463378906
RVBD2586c:secF,5,2,4,0,11,RV2586c,P9WGN9,75.61212921142578
RVBD3898c:RVBD3898c,5,2,4,0,11,RV3898c,O05447,61.217552185058594
RVBD2179c:RVBD2179c,5,2,4,0,11,RV2179c,P9WJ73,95.4455337524414
RVBD1312:RVBD1312,5,2,4,0,11,RV1312,P9WM29,74.69945526123047
RVBD3208:RVBD3208,5,2,4,0,11,RV3208,O05858,87.61552429199219
RVBD3597c:lsr2,4,2,4,1,11,RV3597c,P9WIP7,85.61295318603516
RVBD2894c:xerC,5,2,4,0,11,RV2894c,P9WF35,92.53187561035156
RVBD3923c:rnpA,5,2,4,0,11,RV3923c,P9WGZ3,90.3184585571289
RVBD0517:RVBD0517,5,3,3,0,11,RV0517,O33362,84.6200180053711
RVBD6020:5S,5,4,2,0,11,RV6020,,
RVBD3490:otsA,5,2,4,0,11,RV3490,P9WN11,91.40277862548828
RVBD1011:ispE,5,2,4,0,11,RV1011,P9WKG7,95.29859924316406
RVBD6005:tRNA-Thr6,2,4,3,2,11,RV6005,,
RVBD1100:RVBD1100,5,2,4,0,11,RV1100,O53448,86.11845397949219
RVBD0216:RVBD0216,5,2,4,0,11,RV0216,I6Y340,94.55616760253906
RVBD0024:RVBD0024,5,2,4,0,11,RV0024,P71594,86.58537292480469
RVBD3052c:nrdI,4,3,4,0,11,RV3052c,P9WIZ3,90.70040130615234
RVBD0552:RVBD0552,4,2,5,0,11,RV0552,O06418,96.4150390625
RVBD0807:RVBD0807,5,2,4,0,11,RV0807,I6Y8U3,93.41999816894531
RVBD1603:hisA,4,2,5,0,11,RV1603,P9WMM5,96.64234161376953
RVBD0527:ccdA,3,2,4,2,11,RV0527,L7N671,62.083282470703125
RVBD2922c:smc,5,2,4,0,11,RV2922c,P9WGF3,83.62887573242188
RVBD1010:ksgA,5,2,4,0,11,RV1010,P9WH07,89.93403625488281
RVBD1340:rphA,6,1,3,1,11,RV1340,P9WGZ7,95.49757385253906
RVBD0200:RVBD0200,5,2,4,0,11,RV0200,O53651,88.2948989868164
RVBD6030:tRNA-Arg28,4,2,5,0,11,RV6030,,
RVBD0359:RVBD0359,6,2,3,0,11,RV0359,L0T550,88.3644790649414
RVBD1412:ribC,4,3,4,0,11,RV1412,P9WK35,96.49502563476562
RVBD0205:RVBD0205,5,0,4,2,11,RV0205,P9WFM5,82.52944946289062
RVBD0535:pnp,5,2,4,0,11,RV0535,O06401,92.04443359375
RVBD3394c:RVBD3394c,5,2,4,0,11,RV3394c,O50419,86.52948760986328
RVBD1370c:RVBD1370c,5,2,3,1,11,RV1370c,P9WKH5,91.50304412841797
RVBD0051:RVBD0051,7,1,2,1,11,RV0051,P71708,89.89278411865234
RVBD3922c:RVBD3922c,4,2,5,0,11,RV3922c,P9WFL9,65.72225189208984
RVBD0500:proC,5,2,4,0,11,RV0500,P9WHU7,91.2676010131836
RVBD3279c:birA,3,2,4,2,11,RV3279c,I6YFP0,96.52063751220703
RVBD3907c:pcnA,2,2,6,1,11,RV3907c,L7N672,90.52507781982422
RVBD2257c:RVBD2257c,5,1,4,1,11,RV2257c,O53531,98.01300811767578
RVBD1537:dinX,5,2,3,1,11,RV1537,P9WNT3,87.56123352050781
RVBD3442c:rpsI,4,2,4,1,11,RV3442c,P9WH25,85.97437286376953
RVBD1795:eccD5,4,1,5,1,11,RV1795,P9WNP9,88.17200469970703
RVBD0083:RVBD0083,6,2,2,1,11,RV0083,P9WIW3,92.21885681152344
RVBD2242:RVBD2242,4,2,5,0,11,RV2242,P9WPH5,86.4635238647461
RVBD2587c:secD,5,2,4,0,11,RV2587c,P9WGP1,82.5839614868164
RVBD3025c:iscS,5,2,4,0,11,RV3025c,P9WQ71,96.37539672851562
RVBD0303:RVBD0303,5,2,4,0,11,RV0303,A0A481PC15,
RVBD0525:RVBD0525,3,2,5,1,11,RV0525,O06391,91.24178314208984
RVBD2746c:pgsA3,3,2,5,1,11,RV2746c,P9WPG3,84.3785629272461
RVBD2541:RVBD2541,3,2,5,1,11,RV2541,P95012,77.39888763427734
RVBD0469:umaA,5,2,4,0,11,RV0469,Q6MX39,97.0245132446289
RVBD3773c:RVBD3773c,6,2,3,0,11,RV3773c,P72040,92.5903091430664
RVBD1432:RVBD1432,4,1,6,0,11,RV1432,O06826,94.75318908691406
RVBD3459c:rpsK,5,1,2,3,11,RV3459c,P9WH65,87.80503845214844
RVBD1410c:RVBD1410c,3,2,4,2,11,RV1410c,P9WJY3,81.37549591064453
RVBD0641:rplA,4,2,3,2,11,RV0641,P9WHC7,93.65595245361328
RVBD0467:icl1,3,3,4,1,11,RV0467,P9WKK7,97.39215087890625
RVBD3711c:dnaQ,5,2,3,1,11,RV3711c,O69678,92.4382095336914
RVBD0579:RVBD0579,4,2,4,1,11,RV0579,O53776,90.34111785888672
RVBD1619:RVBD1619,3,3,4,1,11,RV1619,O06136,83.06791687011719
RVBD3220c:RVBD3220c,5,2,4,0,11,RV3220c,P9WGL5,85.05017852783203
RVBD0708:rplP,4,3,3,1,11,RV0708,P9WHD5,95.11572265625
RVBD2416c:eis,5,2,4,0,11,RV2416c,P9WFK7,97.28418731689453
RVBD3046c:RVBD3046c,5,2,4,0,11,RV3046c,I6YF16,72.07837677001953
RVBD2412:rpsT,5,2,4,0,11,RV2412,P9WH41,96.14883422851562
RVBD0423c:thiC,3,2,5,1,11,RV0423c,P9WG79,94.3518295288086
RVBD0084:hycD,5,2,4,0,11,RV0084,Q10881,93.37193298339844
RVBD2172c:RVBD2172c,3,2,4,1,10,RV2172c,O53506,94.3599624633789
RVBD2438A:RVBD2438A,3,2,4,1,10,RV2438A,Q79FD9,53.374351501464844
RVBD3337:RVBD3337,3,2,3,2,10,RV3337,O53387,60.48374938964844
RVBD2051c:ppm1,3,2,4,1,10,RV2051c,O53493,84.14019775390625
RVBD1122:gnd2,4,2,4,0,10,RV1122,O06574,96.45320892333984
RVBD0881:RVBD0881,4,2,4,0,10,RV0881,P9WFY3,90.01388549804688
RVBD1012:RVBD1012,4,2,2,2,10,RV1012,O05597,47.060211181640625
RVBD3221A:rshA,4,2,4,0,10,RV3221A,P9WJ69,84.19672393798828
RVBD2353c:PPE39,6,1,3,0,10,RV2353c,Q79FF3,93.68403625488281
RVBD2444c:rne,3,3,4,0,10,RV2444c,P71905,65.7284927368164
RVBD6045:tRNA-Arg43,3,3,3,1,10,RV6045,,
RVBD1605:hisF,3,2,4,1,10,RV1605,P9WMM3,91.26553344726562
RVBD2841c:nusA,4,2,4,0,10,RV2841c,P9WIV3,91.08783721923828
RVBD2820c:RVBD2820c,5,1,4,0,10,RV2820c,P9WJF7,92.61949920654297
RVBD1559:ilvA,2,2,5,1,10,RV1559,P9WG95,93.04885864257812
RVBD0902c:prrB,3,2,4,1,10,RV0902c,P9WGK7,85.4549789428711
RVBD2877c:RVBD2877c,4,2,4,0,10,RV2877c,H9U196,
RVBD0408:pta,3,1,4,2,10,RV0408,P9WHP1,89.48763275146484
RVBD0591:mce2C,4,2,4,0,10,RV0591,O07787,76.7007827758789
RVBD0936:pstA2,4,1,3,2,10,RV0936,P9WG09,90.98624420166016
RVBD3392c:cmaA1,6,1,3,0,10,RV3392c,P9WPB7,95.8495101928711
RVBD1199c:RVBD1199c,5,2,3,0,10,RV1199c,P60230,86.3543701171875
RVBD2677c:hemY,4,2,4,0,10,RV2677c,P9WMP1,95.8469009399414
RVBD0621:RVBD0621,5,1,4,0,10,RV0621,I6X9F4,77.94483184814453
RVBD2901c:RVBD2901c,4,2,4,0,10,RV2901c,P9WL27,93.47019958496094
RVBD1386:PE15,5,2,3,0,10,RV1386,P9WIH1,95.97137451171875
RVBD0401:RVBD0401,5,1,4,0,10,RV0401,P95210,94.4870834350586
RVBD0592:mce2D,4,2,4,0,10,RV0592,I6WYT7,80.9030990600586
RVBD3914:trxC,4,2,4,0,10,RV3914,P9WG67,94.31094360351562
RVBD1821:secA2,6,1,2,1,10,RV1821,P9WGP3,82.73485565185547
RVBD1005c:pabB,2,3,4,1,10,RV1005c,O05591,87.3905258178711
RVBD0013:trpG,3,2,4,1,10,RV0013,P9WN35,90.88655090332031
RVBD0832:PE-PGRS12,5,1,4,0,10,RV0832,Q79FV8,91.11832427978516
RVBD2374c:hrcA,3,2,4,1,10,RV2374c,P9WMK3,89.9747543334961
RVBD0113:gmhA,5,2,3,0,10,RV0113,P9WGG1,97.12591552734375
RVBD2097c:pafA,3,2,4,1,10,RV2097c,P9WNU7,94.61917877197266
RVBD3219:whiB1,4,2,4,0,10,RV3219,P9WF43,85.03559875488281
RVBD1638:uvrA,4,2,4,0,10,RV1638,P9WQK7,87.45159912109375
RVBD0984:moaB2,4,2,4,0,10,RV0984,O53897,90.86353302001953
RVBD3671c:RVBD3671c,4,3,3,0,10,RV3671c,P9WHR9,90.0498275756836
RVBD1614:lgt,3,2,4,1,10,RV1614,P9WK93,72.08312225341797
RVBD0407:fgd1,4,2,4,0,10,RV0407,P9WNE1,97.12360382080078
RVBD0285:PE5,5,2,3,0,10,RV0285,L7N695,95.8340072631836
RVBD2344c:dgt,4,2,4,0,10,RV2344c,P9WNY7,91.58618927001953
RVBD0377:RVBD0377,5,2,3,0,10,RV0377,P9WMF7,88.97308349609375
RVBD0066c:icd2,4,2,4,0,10,RV0066c,O53611,96.01361083984375
RVBD3231c:RVBD3231c,4,2,4,0,10,RV3231c,O05876,95.16728210449219
RVBD3379c:dxs2,3,2,4,1,10,RV3379c,O50408,94.138671875
RVBD1422:RVBD1422,4,2,3,1,10,RV1422,P9WMU5,90.70895385742188
RVBD2767c:RVBD2767c,5,2,3,0,10,RV2767c,O33309,59.92436218261719
RVBD1622c:cydB,4,2,4,0,10,RV1622c,O06139,92.85930633544922
RVBD0183:RVBD0183,5,2,3,0,10,RV0183,O07427,95.53852844238281
RVBD2241:aceE,3,2,5,0,10,RV2241,P9WIS9,91.86782836914062
RVBD2366c:RVBD2366c,4,2,4,0,10,RV2366c,P9WFP1,84.19779205322266
RVBD0682:rpsL,4,2,4,0,10,RV0682,P9WH63,95.5063705444336
RVBD0188:RVBD0188,2,3,4,1,10,RV0188,O07432,62.742652893066406
RVBD0228:RVBD0228,3,2,4,1,10,RV0228,P96410,87.90335845947266
RVBD0413:mutT3,5,2,3,0,10,RV0413,P9WIX9,88.50736999511719
RVBD0780:purC,3,2,4,1,10,RV0780,P9WHN1,95.30009460449219
RVBD3566A:RVBD3566A,3,2,5,0,10,RV3566A,I6YGI1,60.42352294921875
RVBD2359:zur,4,2,4,0,10,RV2359,P9WN85,93.03861236572266
RVBD1030:kdpB,4,2,4,0,10,RV1030,P9WPU3,84.58342742919922
RVBD1595:nadB,3,0,6,1,10,RV1595,P9WJJ9,94.05985260009766
RVBD3009c:gatB,4,2,4,0,10,RV3009c,P9WN61,91.81449890136719
RVBD1409:ribG,3,2,4,1,10,RV1409,P9WPH1,95.84757995605469
RVBD0361:RVBD0361,4,2,4,0,10,RV0361,O06311,72.26557159423828
RVBD2977c:thiL,3,2,4,1,10,RV2977c,P9WG71,92.56165313720703
RVBD3261:fbiA,2,1,7,0,10,RV3261,P9WP81,95.82029724121094
RVBD0714:rplN,4,2,4,0,10,RV0714,P9WHD9,96.61278533935547
RVBD0717:rpsN1,4,2,3,1,10,RV0717,P9WH57,95.37425994873047
RVBD2973c:recG,5,2,3,0,10,RV2973c,P9WMQ7,80.51895141601562
RVBD0511:hemD,5,2,3,0,10,RV0511,Q6MX34,85.96932220458984
RVBD2534c:efp,3,2,5,0,10,RV2534c,P9WNM3,93.59412384033203
RVBD2737c:recA,5,2,3,0,10,RV2737c,P9WHJ3,83.31208801269531
RVBD0288:esxH,4,2,4,0,10,RV0288,P9WNK3,87.8947982788086
RVBD0026:RVBD0026,5,1,4,0,10,RV0026,P9WMB1,60.80209732055664
RVBD2309c:RVBD2309c,4,2,4,0,10,RV2309c,P71903,81.3797378540039
RVBD1371:RVBD1371,4,1,4,1,10,RV1371,P71799,89.97601318359375
RVBD3239c:RVBD3239c,4,2,4,0,10,RV3239c,O05884,80.85367584228516
RVBD1524:RVBD1524,5,1,4,0,10,RV1524,P9WN07,92.93336486816406
RVBD3460c:rpsM,5,1,4,0,10,RV3460c,P9WH61,91.9072494506836
RVBD3755c:RVBD3755c,6,1,3,0,10,RV3755c,O86358,94.23849487304688
RVBD0634B:rpmG2,4,2,4,0,10,RV0634B,P9WH95,85.25927734375
RVBD3770B:RVBD3770B,4,2,4,0,10,RV3770B,L7N679,97.44762420654297
RVBD1925:fadD31,6,1,2,1,10,RV1925,I6Y7V6,90.85549926757812
RVBD0416:thiS,3,2,4,1,10,RV0416,P96262,94.81307983398438
RVBD0497:RVBD0497,6,1,3,0,10,RV0497,P9WKU3,62.79358673095703
RVBD3041c:RVBD3041c,3,1,5,1,10,RV3041c,I6YF11,89.47686004638672
RVBD6044:tRNA-Ser42,4,2,3,1,10,RV6044,,
RVBD0489:gpm1,4,2,4,0,10,RV0489,P9WIC9,95.4395523071289
RVBD1752:RVBD1752,4,2,4,0,10,RV1752,O06789,60.8558349609375
RVBD1391:dfp,3,3,4,0,10,RV1391,P9WNZ1,93.13538360595703
RVBD0651:rplJ,4,2,3,1,10,RV0651,P9WHE7,86.79853820800781
RVBD0588:yrbE2B,4,2,4,0,10,RV0588,O07790,87.89874267578125
RVBD3014c:ligA,3,3,4,0,10,RV3014c,P9WNV1,88.9043197631836
RVBD1798:eccA5,6,1,3,0,10,RV1798,P9WPI1,92.19021606445312
RVBD0111:RVBD0111,5,1,4,0,10,RV0111,O53633,86.90371704101562
RVBD6025:tRNA-Val23,4,2,3,1,10,RV6025,,
RVBD0512:hemB,4,2,4,0,10,RV0512,P9WMP5,97.1949234008789
RVBD0053:rpsF,4,3,2,1,10,RV0053,P9WH31,95.0581283569336
RVBD0042c:RVBD0042c,5,2,3,0,10,RV0042c,P71699,75.37071990966797
RVBD2358:smtB,4,2,4,0,10,RV2358,P9WMI5,82.63502502441406
RVBD0504c:RVBD0504c,5,2,3,0,10,RV0504c,P9WFK3,90.85891723632812
RVBD6028:tRNA-Pro26,4,3,2,1,10,RV6028,,
RVBD0553:menC,4,2,4,0,10,RV0553,P9WJP3,94.96379852294922
RVBD2438c:nadE,3,2,4,1,10,RV2438c,P9WJJ3,96.33386993408203
RVBD3679:RVBD3679,6,0,4,0,10,RV3679,P9WKX5,87.3382339477539
RVBD2849c:cobO,5,2,3,0,10,RV2849c,I6Y1V6,90.38241577148438
RVBD0415:thiO,4,2,4,0,10,RV0415,P96261,94.4057388305664
RVBD1793:esxN,4,2,3,1,10,RV1793,P9WNJ3,94.23999786376953
RVBD2858c:aldC,5,1,4,0,10,RV2858c,O33340,97.7892074584961
RVBD1059:RVBD1059,4,1,5,0,10,RV1059,O53407,96.21660614013672
RVBD0082:RVBD0082,4,2,4,0,10,RV0082,I6XUD2,94.87986755371094
RVBD2688c:RVBD2688c,5,2,3,0,10,RV2688c,P9WQL7,92.52139282226562
RVBD0811c:RVBD0811c,4,0,6,0,10,RV0811c,I6X9V3,93.40412902832031
RVBD3058c:RVBD3058c,1,2,5,1,9,RV3058c,P95100,88.08422088623047
RVBD1385:pyrF,3,2,4,0,9,RV1385,P9WIU3,95.17449188232422
RVBD1325c:PE-PGRS24,4,2,3,0,9,RV1325c,P9WIF7,96.1259536743164
RVBD0899:ompA,4,1,3,1,9,RV0899,P9WIU5,72.07453918457031
RVBD3713:cobQ2,2,2,4,1,9,RV3713,I6XI14,96.42831420898438
RVBD1296:thrB,3,2,4,0,9,RV1296,P9WKE7,95.1883316040039
RVBD0650:RVBD0650,4,2,3,0,9,RV0650,I6Y8D3,96.37487030029297
RVBD3719:RVBD3719,4,1,4,0,9,RV3719,O69686,91.02825164794922
RVBD0086:hycQ,3,2,4,0,9,RV0086,Q10883,95.86399841308594
RVBD3214:gpm2,3,2,4,0,9,RV3214,Q6MWZ7,96.39556884765625
RVBD0175:RVBD0175,5,1,3,0,9,RV0175,O07419,76.37113189697266
RVBD0297:PE-PGRS5,3,2,4,0,9,RV0297,Q6MX50,73.05091094970703
RVBD0771:RVBD0771,3,2,4,0,9,RV0771,I6Y4S7,89.24388885498047
RVBD1530:adh,5,2,2,0,9,RV1530,P9WQC3,95.89854431152344
RVBD0056:rplI,5,1,3,0,9,RV0056,P9WH79,87.7209243774414
RVBD0246:RVBD0246,4,2,3,0,9,RV0246,O53668,81.57083129882812
RVBD3559c:RVBD3559c,4,2,3,0,9,RV3559c,I6YCF0,95.61182403564453
RVBD1026:RVBD1026,4,2,3,0,9,RV1026,P96374,96.76254272460938
RVBD0875c:RVBD0875c,4,1,4,0,9,RV0875c,P9WKR7,93.39827728271484
RVBD3351c:RVBD3351c,5,2,2,0,9,RV3351c,O50380,75.83931732177734
RVBD1659:argH,3,1,4,1,9,RV1659,P9WPY7,95.85427856445312
RVBD2504c:scoA,5,2,2,0,9,RV2504c,P9WPW5,97.13347625732422
RVBD3816c:RVBD3816c,4,1,4,0,9,RV3816c,O07807,93.04235076904297
RVBD1029:kdpA,4,2,3,0,9,RV1029,P9WKF3,95.90251922607422
RVBD0532:PE-PGRS6,2,3,4,0,9,RV0532,L0T3X8,85.58370208740234
RVBD2728c:RVBD2728c,3,2,4,0,9,RV2728c,I6X579,96.15220642089844
RVBD2398c:cysW,3,1,5,0,9,RV2398c,P71746,92.17577362060547
RVBD2955c:RVBD2955c,4,1,4,0,9,RV2955c,P95137,77.04753875732422
RVBD2211c:gcvT,4,2,3,0,9,RV2211c,P9WN51,97.16255950927734
RVBD1003:RVBD1003,4,1,4,0,9,RV1003,P9WGW7,93.74319458007812
RVBD3469c:mhpE,4,2,3,0,9,RV3469c,O06334,94.01142883300781
RVBD3215:entC,4,1,4,0,9,RV3215,P9WFW9,94.29888916015625
RVBD2363:amiA2,5,1,3,0,9,RV2363,P9WQ99,94.41289520263672
RVBD2554c:RVBD2554c,3,1,4,1,9,RV2554c,P9WGV7,84.90093994140625
RVBD3032:RVBD3032,4,1,3,1,9,RV3032,P9WMY9,94.74769592285156
RVBD0823c:RVBD0823c,5,1,3,0,9,RV0823c,P9WNS7,93.82987213134766
RVBD1854c:ndh,3,1,5,0,9,RV1854c,P95160,93.24300384521484
RVBD2833c:ugpB,5,3,1,0,9,RV2833c,P71619,92.62474822998047
RVBD3166c:RVBD3166c,4,1,4,0,9,RV3166c,O53316,66.32893371582031
RVBD3894c:eccC2,4,2,3,0,9,RV3894c,O05450,83.1253662109375
RVBD1643:rplT,1,2,6,0,9,RV1643,P9WHC5,94.85619354248047
RVBD2488c:RVBD2488c,3,2,4,0,9,RV2488c,O53213,83.6922378540039
RVBD0063:RVBD0063,4,2,3,0,9,RV0063,O53608,92.46987915039062
RVBD1014c:pth,3,2,4,0,9,RV1014c,P9WHN7,96.50104522705078
RVBD2364c:era,3,2,4,0,9,RV2364c,P9WNK9,93.615966796875
RVBD3026c:RVBD3026c,6,1,2,0,9,RV3026c,I6XFY8,82.95365142822266
RVBD3176c:mesT,4,2,3,0,9,RV3176c,Q6MX03,91.66541290283203
RVBD1170:mshB,5,1,3,0,9,RV1170,P9WJN3,95.03662872314453
RVBD3002c:ilvN,3,2,4,0,9,RV3002c,P9WKJ3,92.6417236328125
RVBD2995c:leuB,2,2,4,1,9,RV2995c,P9WKK9,97.8955078125
RVBD1403c:RVBD1403c,2,3,4,0,9,RV1403c,P9WLY9,93.54025268554688
RVBD3057c:RVBD3057c,4,2,3,0,9,RV3057c,I6YB11,91.48515319824219
RVBD2975A:RVBD2975A,3,1,2,3,9,RV2975A,P0DV54,
RVBD1083:RVBD1083,5,0,3,1,9,RV1083,O53431,73.58238983154297
RVBD1783:eccC5,3,2,2,2,9,RV1783,P9WNA5,83.10287475585938
RVBD2136c:RVBD2136c,3,2,4,0,9,RV2136c,P9WFF9,94.04510498046875
RVBD6010:tRNA-Glu11,5,1,3,0,9,RV6010,,
RVBD0937c:mku,4,2,3,0,9,RV0937c,P9WKD9,87.48241424560547
RVBD0018c:pstP,4,2,3,0,9,RV0018c,P9WHW5,81.2078857421875
RVBD3730c:RVBD3730c,5,2,2,0,9,RV3730c,O69697,94.54373168945312
RVBD0994:moeA1,6,1,2,0,9,RV0994,P9WJQ7,90.36608123779297
RVBD0733:adk,3,2,4,0,9,RV0733,P9WKF5,95.73663330078125
RVBD0019c:fhaB,4,2,3,0,9,RV0019c,P9WJB5,83.03502655029297
RVBD6031:tRNA-His29,5,1,3,0,9,RV6031,,
RVBD1201c:dapD,3,2,3,1,9,RV1201c,P9WP21,95.18975067138672
RVBD0509:hemA,3,2,4,0,9,RV0509,P9WMP7,86.76251983642578
RVBD0856:RVBD0856,4,2,3,0,9,RV0856,O53868,81.71589660644531
RVBD2785c:rpsO,4,2,3,0,9,RV2785c,P9WH55,95.59808349609375
RVBD1072:RVBD1072,3,2,4,0,9,RV1072,O53420,84.43104553222656
RVBD2282c:RVBD2282c,5,1,3,0,9,RV2282c,P9WMF3,91.62525939941406
RVBD2239c:RVBD2239c,4,1,4,0,9,RV2239c,P9WLG9,86.11524963378906
RVBD1298:rpmE,3,2,4,0,9,RV1298,P9WHA1,73.68824768066406
RVBD0245:RVBD0245,5,1,3,0,9,RV0245,O53667,94.12777709960938
RVBD1991A:mazE6,4,2,3,0,9,RV1991A,P9WJ87,87.09817504882812
RVBD2710:sigB,3,1,5,0,9,RV2710,P9WGI5,89.94934844970703
RVBD1420:uvrC,4,1,4,0,9,RV1420,P9WFC5,81.89147186279297
RVBD1610:RVBD1610,1,2,4,2,9,RV1610,O06128,66.3983383178711
RVBD3802c:RVBD3802c,3,0,6,0,9,RV3802c,O53581,89.82940673828125
RVBD2124c:metH,3,2,4,0,9,RV2124c,O33259,88.94274139404297
RVBD1475c:acn,4,2,3,0,9,RV1475c,O53166,92.06999206542969
RVBD1082:mca,3,2,4,0,9,RV1082,P9WJN1,94.70381927490234
RVBD2822c:RVBD2822c,5,2,2,0,9,RV2822c,P9WJG1,95.49967193603516
RVBD3664c:dppC,5,0,4,0,9,RV3664c,L0TEV4,93.94624328613281
RVBD2603c:RVBD2603c,3,1,5,0,9,RV2603c,P9WGA5,90.46932220458984
RVBD0102:RVBD0102,2,2,4,1,9,RV0102,P9WM63,90.43087768554688
RVBD1202:dapE,3,1,4,1,9,RV1202,P9WHS9,96.21680450439453
RVBD1500:RVBD1500,4,2,3,0,9,RV1500,P9WMX5,83.2073974609375
RVBD2447c:folC,2,2,4,1,9,RV2447c,I6Y0R5,92.63096618652344
RVBD3520c:RVBD3520c,4,2,3,0,9,RV3520c,O53565,95.7685546875
RVBD2588c:yajC,5,1,3,0,9,RV2588c,P9WL75,80.89183044433594
RVBD2967c:pca,4,3,2,0,9,RV2967c,I6YEU0,91.65065002441406
RVBD3414c:sigD,4,2,2,1,9,RV3414c,P9WGG9,80.8677749633789
RVBD2834c:ugpE,3,1,4,1,9,RV2834c,I6Y1U3,91.07254028320312
RVBD0986:RVBD0986,3,2,3,1,9,RV0986,P9WQK1,89.9528579711914
RVBD2802c:RVBD2802c,4,2,3,0,9,RV2802c,P71649,91.52190399169922
RVBD3205c:RVBD3205c,2,3,4,0,9,RV3205c,O05861,93.774658203125
RVBD2535c:pepQ,2,1,3,3,9,RV2535c,I6YDN6,96.37322235107422
RVBD1173:fbiC,3,0,5,1,9,RV1173,P9WP77,91.5060806274414
RVBD3640c:RVBD3640c,4,1,4,0,9,RV3640c,O06367,89.1607894897461
RVBD2373c:dnaJ2,5,0,4,0,9,RV2373c,P9WNV7,85.49148559570312
RVBD0769:RVBD0769,5,1,3,0,9,RV0769,P9WGQ9,96.79854583740234
RVBD2484c:RVBD2484c,4,2,3,0,9,RV2484c,P9WKB3,84.66939544677734
RVBD1254:RVBD1254,3,1,4,1,9,RV1254,Q11064,90.03488159179688
RVBD1250:RVBD1250,3,3,3,0,9,RV1250,P9WG87,76.79378509521484
RVBD0997:RVBD0997,4,2,3,0,9,RV0997,O05580,41.73699188232422
RVBD0085:hycP,4,2,3,0,9,RV0085,P9WM75,85.82249450683594
RVBD2210c:ilvE,4,2,3,0,9,RV2210c,P9WQ75,96.3697280883789
RVBD0906:RVBD0906,3,2,3,1,9,RV0906,P9WKP3,89.22145080566406
RVBD3471c:RVBD3471c,3,2,4,0,9,RV3471c,O06336,81.7935562133789
RVBD1601:hisB,3,2,3,1,9,RV1601,P9WML9,95.4643325805664
RVBD1662:pks8,3,2,4,0,9,RV1662,O65933,88.90460968017578
RVBD2151c:ftsQ,4,1,3,1,9,RV2151c,P9WNA1,83.1664047241211
RVBD0326:RVBD0326,3,2,4,0,9,RV0326,O07251,96.54853820800781
RVBD3895c:eccB2,4,1,4,0,9,RV3895c,P9WNR5,91.49019622802734
RVBD0064A:vapB1,3,2,4,0,9,RV0064A,P0CW29,86.0889892578125
RVBD2792c:RVBD2792c,5,1,2,1,9,RV2792c,I6YA93,89.91160583496094
RVBD1178:RVBD1178,3,2,4,0,9,RV1178,O50434,96.82192993164062
RVBD2954c:RVBD2954c,3,1,4,0,8,RV2954c,I6X5U4,93.88493347167969
RVBD0948c:RVBD0948c,2,2,4,0,8,RV0948c,P9WIC1,86.25695037841797
RVBD3514:PE-PGRS57,4,1,3,0,8,RV3514,Q6MWW6,45.2650146484375
RVBD3518c:cyp142,4,2,2,0,8,RV3518c,P9WPL5,94.64424896240234
RVBD3180c:RVBD3180c,3,1,4,0,8,RV3180c,P9WF51,96.90020751953125
RVBD0909:RVBD0909,3,2,3,0,8,RV0909,P9WJ07,74.28897857666016
RVBD3107c:agpS,5,1,2,0,8,RV3107c,O05784,94.2401351928711
RVBD0322:udgA,4,1,2,1,8,RV0322,O07248,96.45295715332031
RVBD2907c:rimM,4,2,2,0,8,RV2907c,P9WH19,92.09465789794922
RVBD1472:echA12,3,1,4,0,8,RV1472,P9WNN7,93.74456787109375
RVBD3481c:RVBD3481c,5,0,3,0,8,RV3481c,I6XHC3,68.32279968261719
RVBD1060:RVBD1060,4,2,2,0,8,RV1060,O53408,93.92509460449219
RVBD2425c:RVBD2425c,3,2,3,0,8,RV2425c,P71923,79.2323989868164
RVBD3482c:RVBD3482c,4,2,2,0,8,RV3482c,I6YG92,83.39238739013672
RVBD0614:RVBD0614,3,2,3,0,8,RV0614,O07763,47.16051483154297
RVBD2322c:rocD1,3,2,3,0,8,RV2322c,P71890,93.63796997070312
RVBD3567c:hsaB,4,2,1,1,8,RV3567c,P9WND9,92.11389923095703
RVBD2986c:hupB,2,2,3,1,8,RV2986c,P9WMK7,71.44831848144531
RVBD0538:RVBD0538,3,1,4,0,8,RV0538,O06404,65.58043670654297
RVBD3289c:RVBD3289c,3,1,4,0,8,RV3289c,P96894,63.765995025634766
RVBD1716:RVBD1716,3,2,3,0,8,RV1716,O53929,96.37300872802734
RVBD3402c:RVBD3402c,3,1,4,0,8,RV3402c,P9WGJ7,91.89781188964844
RVBD3502c:RVBD3502c,3,2,3,0,8,RV3502c,O53547,93.32022094726562
RVBD0930:pstA1,3,2,3,0,8,RV0930,P9WG11,91.57188415527344
RVBD0521:RVBD0521,4,1,3,0,8,RV0521,L7N6C0,65.69633483886719
RVBD2072c:cobL,3,2,3,0,8,RV2072c,P9WGA9,95.32179260253906
RVBD3470c:ilvB2,2,2,3,1,8,RV3470c,O06335,91.472900390625
RVBD0404:fadD30,3,2,3,0,8,RV0404,P9WQ57,86.90309143066406
RVBD3612c:RVBD3612c,3,2,3,0,8,RV3612c,I6YGR2,36.80733871459961
RVBD3533c:PPE62,5,0,3,0,8,RV3533c,P9WHX7,95.02928924560547
RVBD2922A:acyP,4,1,3,0,8,RV2922A,P9WQC9,95.16280364990234
RVBD0023:RVBD0023,3,3,1,1,8,RV0023,P9WMI3,87.90519714355469
RVBD0382c:pyrE,2,1,4,1,8,RV0382c,P9WHK9,93.19721221923828
RVBD0218:RVBD0218,4,1,3,0,8,RV0218,P96400,90.77352905273438
RVBD0458:RVBD0458,3,1,3,1,8,RV0458,P9WNY1,97.93518829345703
RVBD2796c:lppV,3,1,4,0,8,RV2796c,P71655,87.43272399902344
RVBD1076:lipU,4,1,3,0,8,RV1076,O53424,94.83784484863281
RVBD1277:RVBD1277,3,2,3,0,8,RV1277,Q50699,89.45331573486328
RVBD0522:gabP,3,2,3,0,8,RV0522,L7N6B9,86.50116729736328
RVBD2350c:plcB,2,2,4,0,8,RV2350c,P9WIB3,86.92683410644531
RVBD1120c:RVBD1120c,3,2,3,0,8,RV1120c,O06572,72.63743591308594
RVBD3647c:RVBD3647c,4,2,2,0,8,RV3647c,I6Y469,93.9059829711914
RVBD3213c:RVBD3213c,5,1,2,0,8,RV3213c,O05853,92.55545043945312
RVBD3696c:glpK,4,2,1,1,8,RV3696c,P9WPK1,94.17913055419922
RVBD3714c:RVBD3714c,4,2,2,0,8,RV3714c,O69681,91.77172088623047
RVBD0242c:fabG4,5,1,2,0,8,RV0242c,I6Y778,94.43412017822266
RVBD2889c:tsf,3,2,3,0,8,RV2889c,P9WNM1,95.19169616699219
RVBD2400c:subI,3,1,4,0,8,RV2400c,P71744,89.80207824707031
RVBD1797:eccE5,4,1,2,1,8,RV1797,P9WJE3,76.7584457397461
RVBD0391:metZ,3,0,5,0,8,RV0391,P9WGB5,97.08613586425781
RVBD2184c:RVBD2184c,4,1,3,0,8,RV2184c,O53518,87.16387939453125
RVBD3603c:RVBD3603c,2,2,4,0,8,RV3603c,O06279,94.79805755615234
RVBD3687c:rsfB,5,1,2,0,8,RV3687c,P9WGE1,91.14942932128906
RVBD2050:RVBD2050,2,3,2,1,8,RV2050,P9WHJ5,85.7203598022461
RVBD0450c:mmpL4,4,1,1,2,8,RV0450c,P9WJV3,84.52587127685547
RVBD0548c:menB,1,2,4,1,8,RV0548c,P9WNP5,94.01789855957031
RVBD2829c:RVBD2829c,3,2,3,0,8,RV2829c,P71623,97.08446502685547
RVBD2569c:RVBD2569c,2,1,5,0,8,RV2569c,P9WL93,91.31298828125
RVBD0437c:psd,3,1,4,0,8,RV0437c,P9WHQ5,91.85099792480469
RVBD2000:RVBD2000,3,2,3,0,8,RV2000,P9WLN7,88.09593963623047
RVBD0715:rplX,3,3,2,0,8,RV0715,P9WHB7,91.24589538574219
RVBD1709:scpA,3,2,3,0,8,RV1709,O33208,77.90179443359375
RVBD2615c:PE-PGRS45,4,2,2,0,8,RV2615c,Q79FC3,92.6202621459961
RVBD2476c:gdh,4,0,1,3,8,RV2476c,O53203,87.22659301757812
RVBD0032:bioF2,2,2,3,1,8,RV0032,P9WQ85,93.11514282226562
RVBD2018:RVBD2018,3,1,4,0,8,RV2018,O53464,93.66902923583984
RVBD0054:ssb,3,2,3,0,8,RV0054,P9WGD5,84.80244445800781
RVBD0224c:RVBD0224c,2,2,4,0,8,RV0224c,P9WJZ9,90.72464752197266
RVBD3345c:PE-PGRS50,2,2,3,1,8,RV3345c,Q6MWY0,72.17527770996094
RVBD2672:RVBD2672,4,1,2,1,8,RV2672,P71969,90.7428970336914
RVBD2847c:cysG,2,2,4,0,8,RV2847c,I6X5I7,91.27234649658203
RVBD2721c:RVBD2721c,3,1,4,0,8,RV2721c,I6XF52,72.79891967773438
RVBD0390:RVBD0390,5,2,1,0,8,RV0390,P95198,95.20950317382812
RVBD1796:mycP5,4,1,2,1,8,RV1796,O53945,79.1028060913086
RVBD0157:pntB,4,0,4,0,8,RV0157,P96834,88.66092681884766
RVBD3789:RVBD3789,2,1,4,1,8,RV3789,P9WMS9,78.99223327636719
RVBD3340:metC,3,1,3,1,8,RV3340,O53390,94.00240325927734
RVBD0124:PE-PGRS2,4,1,3,0,8,RV0124,Q79G08,91.3106918334961
RVBD0064:RVBD0064,4,1,3,0,8,RV0064,P9WFL5,87.96102905273438
RVBD3752c:RVBD3752c,3,3,2,0,8,RV3752c,O69719,97.01526641845703
RVBD0168:yrbE1B,3,2,3,0,8,RV0168,L0T2Q9,88.16314697265625
RVBD0429c:def,3,1,4,0,8,RV0429c,P9WIJ3,96.57299041748047
RVBD0500A:RVBD0500A,2,2,4,0,8,RV0500A,P9WKT7,79.19564056396484
RVBD1458c:RVBD1458c,2,1,3,2,8,RV1458c,O53149,90.62910461425781
RVBD0563:htpX,3,1,4,0,8,RV0563,P9WHS5,87.55968475341797
RVBD0442c:PPE10,2,2,4,0,8,RV0442c,P9WI41,73.43292236328125
RVBD3028c:fixB,1,2,5,0,8,RV3028c,P9WNG9,95.6539306640625
RVBD2139:pyrD,1,2,4,1,8,RV2139,P9WHL1,95.98492431640625
RVBD1512:epiA,3,2,2,1,8,RV1512,P71791,94.47357177734375
RVBD0258c:RVBD0258c,4,1,3,0,8,RV0258c,P95215,90.91053009033203
RVBD3810:pirG,3,0,5,0,8,RV3810,P9WIQ7,55.20930099487305
RVBD1047:RVBD1047,4,1,3,0,8,RV1047,P96354,85.13510131835938
RVBD0459:RVBD0459,3,2,3,0,8,RV0459,O53744,90.1669921875
RVBD0483:lprQ,3,1,4,0,8,RV0483,P9WKV3,86.50791931152344
RVBD0934:pstS1,3,2,3,0,8,RV0934,P9WGU1,92.82229614257812
RVBD2231c:cobC,4,2,2,0,8,RV2231c,P9WQ89,89.22409057617188
RVBD1465:RVBD1465,1,1,5,1,8,RV1465,O53156,94.21031188964844
RVBD1421:RVBD1421,2,0,6,0,8,RV1421,P9WFQ3,87.25508880615234
RVBD1114:vapC32,5,1,2,0,8,RV1114,P9WF73,95.27153015136719
RVBD2859c:RVBD2859c,3,2,3,0,8,RV2859c,O33341,85.40596771240234
RVBD1794:RVBD1794,3,1,3,1,8,RV1794,O53943,93.31430053710938
RVBD3540c:ltp2,4,2,2,0,8,RV3540c,I6Y3T7,97.31181335449219
RVBD1098c:fum,3,1,4,0,8,RV1098c,P9WN93,96.9280776977539
RVBD6027:tRNA-Asn25,4,1,2,1,8,RV6027,,
RVBD0817c:RVBD0817c,3,1,4,0,8,RV0817c,I6WZH9,93.05048370361328
RVBD1285:cysD,3,1,4,0,8,RV1285,P9WIK1,90.05423736572266
RVBD0736:rslA,3,2,3,0,8,RV0736,P9WJ67,81.44999694824219
RVBD2510c:RVBD2510c,2,2,4,0,8,RV2510c,I6Y0X6,84.49885559082031
RVBD3036c:TB22.2,4,2,2,0,8,RV3036c,I6YF08,89.52497863769531
RVBD3132c:devS,3,2,3,0,8,RV3132c,P9WGK3,84.95814514160156
RVBD3306c:amiB1,4,1,3,0,8,RV3306c,L7N690,96.77630615234375
RVBD0436c:pssA,2,1,5,0,8,RV0436c,P9WPG1,81.44559478759766
RVBD3492c:RVBD3492c,5,1,2,0,8,RV3492c,I6YGA5,95.02862548828125
RVBD2583c:relA,3,2,3,0,8,RV2583c,P9WHG9,81.41087341308594
RVBD2164c:RVBD2164c,2,2,4,0,8,RV2164c,O06213,62.169429779052734
RVBD2690c:RVBD2690c,4,2,2,0,8,RV2690c,I6Y1H7,87.26494598388672
RVBD2130c:mshC,3,1,4,0,8,RV2130c,P9WJM9,96.22914123535156
RVBD1274:lprB,2,2,4,0,8,RV1274,P9WK53,86.40951538085938
RVBD0486:mshA,3,1,4,0,8,RV0486,P9WMY7,87.9247055053711
RVBD1124:ephC,4,2,2,0,8,RV1124,O06576,93.45747375488281
RVBD2391:sirA,2,2,4,0,8,RV2391,P9WJ03,97.1056137084961
RVBD0785:RVBD0785,2,2,4,0,8,RV0785,P71838,93.25248718261719
RVBD3892c:PPE69,3,1,4,0,8,RV3892c,P9WHW7,62.104557037353516
RVBD2958c:RVBD2958c,2,2,3,1,8,RV2958c,P9WFR1,90.77674865722656
RVBD1090:celA2b,3,1,4,0,8,RV1090,O53438,96.43331146240234
RVBD1360:RVBD1360,3,1,3,0,7,RV1360,P9WM03,95.900146484375
RVBD0395:RVBD0395,4,1,2,0,7,RV0395,P95203,59.419105529785156
RVBD1981c:nrdF1,2,1,4,0,7,RV1981c,P9WH73,91.79021453857422
RVBD1693:RVBD1693,4,1,2,0,7,RV1693,O33195,76.59966278076172
RVBD0220:lipC,2,0,4,1,7,RV0220,P96402,86.78890991210938
RVBD0619:galTb,5,0,2,0,7,RV0619,Q79FY3,86.55602264404297
RVBD2303c:RVBD2303c,3,2,2,0,7,RV2303c,Q50662,95.1097412109375
RVBD0049:RVBD0049,3,1,2,1,7,RV0049,P9WM85,88.44131469726562
RVBD3038c:RVBD3038c,3,0,4,0,7,RV3038c,I6YAZ1,91.54293060302734
RVBD2777c:RVBD2777c,1,1,4,1,7,RV2777c,O33319,80.82508850097656
RVBD0155:pntAa,4,1,2,0,7,RV0155,P96832,94.66519165039062
RVBD3341:metA,3,1,3,0,7,RV3341,P9WJY9,96.48099517822266
RVBD0050:ponA1,1,2,4,0,7,RV0050,P71707,80.1524887084961
RVBD1438:tpi,2,1,4,0,7,RV1438,P9WG43,96.93975830078125
RVBD1400c:lipI,2,2,3,0,7,RV1400c,P71668,94.86799621582031
RVBD1236:sugA,5,1,1,0,7,RV1236,P9WG03,89.84012603759766
RVBD2882c:frr,2,2,2,1,7,RV2882c,P9WGY1,94.1216812133789
RVBD3720:RVBD3720,3,0,4,0,7,RV3720,O69687,89.6311264038086
RVBD3222c:RVBD3222c,4,1,2,0,7,RV3222c,O05844,48.23699951171875
RVBD2125:RVBD2125,2,1,4,0,7,RV2125,O33260,89.00126647949219
RVBD0281:RVBD0281,3,2,2,0,7,RV0281,P9WFI9,93.67301177978516
RVBD3018Bc:RVBD3018Bc,3,1,3,0,7,RV3018Bc,,
RVBD0961:RVBD0961,4,1,2,0,7,RV0961,P9WKM9,87.96504974365234
RVBD0737:RVBD0737,2,1,4,0,7,RV0737,I6Y8K3,95.119873046875
RVBD1189:sigI,2,2,3,0,7,RV1189,P9WGH3,77.44244384765625
RVBD3625c:mesJ,3,2,2,0,7,RV3625c,P9WG53,93.63378143310547
RVBD1698:mctB,3,1,3,0,7,RV1698,P9WJ83,87.96257781982422
RVBD3854c:ethA,3,0,3,1,7,RV3854c,P9WNF9,94.72476196289062
RVBD1230c:RVBD1230c,2,2,3,0,7,RV1230c,O86313,67.18228149414062
RVBD0417:thiG,1,2,4,0,7,RV0417,P9WG73,94.11821746826172
RVBD0211:pckA,2,1,4,0,7,RV0211,P9WIH3,96.6192398071289
RVBD2609c:RVBD2609c,2,1,3,1,7,RV2609c,I6YDV4,85.4541244506836
RVBD3657c:RVBD3657c,3,1,3,0,7,RV3657c,O69625,86.08167266845703
RVBD2427Ac:RVBD2427Ac,3,1,3,0,7,RV2427Ac,,
RVBD2763c:dfrA,2,1,4,0,7,RV2763c,P9WNX1,96.24601745605469
RVBD3823c:mmpL8,1,1,4,1,7,RV3823c,P9WJU5,81.02944946289062
RVBD2498c:citE,4,1,2,0,7,RV2498c,P9WPE1,95.95806121826172
RVBD3762c:RVBD3762c,4,2,1,0,7,RV3762c,O69728,95.08126068115234
RVBD0079:RVBD0079,2,1,4,0,7,RV0079,P9WMA9,86.64307403564453
RVBD0462:lpdC,3,1,3,0,7,RV0462,P9WHH9,97.51508331298828
RVBD3508:PE-PGRS54,3,2,2,0,7,RV3508,O53553,41.73875427246094
RVBD0582:vapC26,5,1,1,0,7,RV0582,O53779,96.38851928710938
RVBD3573c:fadE34,3,1,2,1,7,RV3573c,P96855,92.85054016113281
RVBD0385:RVBD0385,4,0,3,0,7,RV0385,Q7ARS9,94.3321533203125
RVBD2413c:RVBD2413c,3,1,3,0,7,RV2413c,P71730,91.19689178466797
RVBD1652:argC,1,2,4,0,7,RV1652,P9WPZ9,97.04678344726562
RVBD1859:modC,4,1,2,0,7,RV1859,P9WQL3,89.9650650024414
RVBD1253:deaD,1,3,2,1,7,RV1253,P9WH05,85.12232971191406
RVBD3850:RVBD3850,4,0,3,0,7,RV3850,P96227,80.95806884765625
RVBD2794c:pptT,3,2,2,0,7,RV2794c,O33336,96.1207046508789
RVBD2261c:RVBD2261c,1,2,4,0,7,RV2261c,I6XDW5,94.73271179199219
RVBD2442c:rplU,2,2,3,0,7,RV2442c,P9WHC3,93.075439453125
RVBD0911:RVBD0911,2,2,3,0,7,RV0911,I6XA34,95.87618255615234
RVBD1453:RVBD1453,4,1,2,0,7,RV1453,O06807,88.63985443115234
RVBD0698:RVBD0698,2,2,3,0,7,RV0698,P95044,27.041723251342773
RVBD0584:RVBD0584,3,2,2,0,7,RV0584,O86365,94.95096588134766
RVBD3428c:RVBD3428c,4,1,2,0,7,RV3428c,Q50700,84.14649200439453
RVBD1599:hisD,2,2,3,0,7,RV1599,P9WNW9,95.63094329833984
RVBD1556:RVBD1556,2,2,3,0,7,RV1556,P9WMD1,88.8052978515625
RVBD0214:fadD4,2,1,4,0,7,RV0214,P96396,89.34461975097656
RVBD0784:RVBD0784,3,2,2,0,7,RV0784,P71837,90.93824005126953
RVBD1025:RVBD1025,1,2,4,0,7,RV1025,P96375,94.34445190429688
RVBD3883c:mycP1,3,1,3,0,7,RV3883c,O05461,92.39643859863281
RVBD0892:RVBD0892,3,2,2,0,7,RV0892,P9WNG1,92.68892669677734
RVBD2537c:aroD,2,1,4,0,7,RV2537c,P9WPX7,94.92496490478516
RVBD3389c:htdY,4,0,3,0,7,RV3389c,I6YBZ8,96.11203002929688
RVBD0229Ac:RVBD0229Ac,1,2,3,1,7,RV0229Ac,,
RVBD3339c:icd1,3,1,2,1,7,RV3339c,P9WKL1,95.72683715820312
RVBD3004:cfp6,2,1,4,0,7,RV3004,P9WIR1,68.80634307861328
RVBD0109:PE-PGRS1,1,2,4,0,7,RV0109,L0T2H7,95.8622817993164
RVBD0622:RVBD0622,2,1,4,0,7,RV0622,P96912,83.3208236694336
RVBD0539:RVBD0539,3,1,3,0,7,RV0539,P9WMY1,88.98734283447266
RVBD3450c:eccB4,2,2,2,1,7,RV3450c,P9WNR1,88.8658218383789
RVBD0080:RVBD0080,3,2,2,0,7,RV0080,P9WMA5,82.62809753417969
RVBD3262:fbiB,2,0,5,0,7,RV3262,P9WP79,95.57560729980469
RVBD2711:ideR,2,1,4,0,7,RV2711,P9WMH1,95.36739349365234
RVBD2483c:plsC,2,1,3,1,7,RV2483c,I6YDI9,79.63558959960938
RVBD0871:cspB,3,1,3,0,7,RV0871,I6WZM9,83.1042251586914
RVBD3232c:ppk2,2,2,3,0,7,RV3232c,O05877,89.02176666259766
RVBD1824:RVBD1824,2,0,2,3,7,RV1824,P9WLR7,90.07420349121094
RVBD3582c:ispD,3,2,2,0,7,RV3582c,P9WKG9,91.90403747558594
RVBD2990c:RVBD2990c,3,1,2,1,7,RV2990c,I6YEW1,92.28783416748047
RVBD0820:phoT,3,1,3,0,7,RV0820,P9WQL1,95.25814056396484
RVBD0062:celA1,3,1,3,0,7,RV0062,Q79G13,86.6639633178711
RVBD2420c:RVBD2420c,2,1,4,0,7,RV2420c,O86327,87.50808715820312
RVBD2217:lipB,3,2,2,0,7,RV2217,P9WK83,95.3468246459961
RVBD0928:pstS3,4,1,2,0,7,RV0928,P9WGT7,91.39205932617188
RVBD0362:mgtE,3,2,2,0,7,RV0362,O06312,91.24082946777344
RVBD2864c:RVBD2864c,2,2,3,0,7,RV2864c,O33346,93.59126281738281
RVBD1735c:RVBD1735c,2,2,3,0,7,RV1735c,P9WLS5,66.06995391845703
RVBD1513:RVBD1513,3,1,3,0,7,RV1513,P71792,94.54338836669922
RVBD1087A:RVBD1087A,3,2,2,0,7,RV1087A,L7N654,61.39764404296875
RVBD0488:RVBD0488,3,1,3,0,7,RV0488,P9WK33,83.09169006347656
RVBD3001c:ilvC,1,2,3,1,7,RV3001c,P9WKJ7,96.25062561035156
RVBD1492:mutA,3,1,3,0,7,RV1492,P9WJK7,96.4621810913086
RVBD3779:RVBD3779,3,1,0,3,7,RV3779,P72045,92.72393798828125
RVBD1815:RVBD1815,1,2,4,0,7,RV1815,P9WLR9,90.6799087524414
RVBD3267:RVBD3267,3,0,3,1,7,RV3267,P96872,86.44879150390625
RVBD3650:PE33,3,2,2,0,7,RV3650,I6X7Z8,87.92350769042969
RVBD2404c:lepA,2,1,4,0,7,RV2404c,P9WK97,82.57347869873047
RVBD2238c:ahpE,3,0,2,2,7,RV2238c,P9WIE3,98.25752258300781
RVBD0034:RVBD0034,4,1,2,0,7,RV0034,P9WM93,95.87176513671875
RVBD2733c:RVBD2733c,4,1,2,0,7,RV2733c,P9WK05,83.87162017822266
RVBD0231:fadE4,2,1,4,0,7,RV0231,P96414,96.70408630371094
RVBD3629c:RVBD3629c,4,1,1,1,7,RV3629c,O06378,84.99855041503906
RVBD1701:RVBD1701,4,0,3,0,7,RV1701,P9WF33,89.89411926269531
RVBD0028:RVBD0028,2,2,3,0,7,RV0028,P9WM97,96.0014877319336
RVBD0087:hycE,3,1,3,0,7,RV0087,Q10884,95.09225463867188
RVBD1171:RVBD1171,2,3,2,0,7,RV1171,O50427,55.13541030883789
RVBD2362c:recO,1,2,3,1,7,RV2362c,P9WHI5,90.60905456542969
RVBD1616:RVBD1616,3,2,1,0,6,RV1616,O06133,85.16584014892578
RVBD2988c:leuC,3,2,1,0,6,RV2988c,P9WQF5,96.7408218383789
RVBD3106:fprA,1,2,3,0,6,RV3106,P9WIQ3,95.32064056396484
RVBD2222c:glnA2,1,2,3,0,6,RV2222c,P9WN37,93.34569549560547
RVBD2732c:RVBD2732c,2,1,3,0,6,RV2732c,O33237,64.85720825195312
RVBD3702c:RVBD3702c,0,2,4,0,6,RV3702c,O69670,96.02115631103516
RVBD3438:RVBD3438,3,0,3,0,6,RV3438,I6X7B3,91.9532470703125
RVBD1654:argB,2,2,2,0,6,RV1654,P9WQ01,94.60720825195312
RVBD2264c:RVBD2264c,3,1,2,0,6,RV2264c,O53538,73.49915313720703
RVBD1785c:cyp143,1,1,4,0,6,RV1785c,P9WPL3,93.93273162841797
RVBD3395A:RVBD3395A,2,2,2,0,6,RV3395A,Q6MWX4,87.87783813476562
RVBD2860c:glnA4,1,2,3,0,6,RV2860c,I6X5K1,95.80303192138672
RVBD2736c:recX,3,0,3,0,6,RV2736c,P9WHI1,91.52983093261719
RVBD2959c:RVBD2959c,4,1,1,0,6,RV2959c,P9WIM5,95.4284896850586
RVBD3294c:RVBD3294c,3,1,1,1,6,RV3294c,L7N658,82.68925476074219
RVBD2390c:RVBD2390c,3,2,1,0,6,RV2390c,P71754,87.06389617919922
RVBD0604:lpqO,2,2,2,0,6,RV0604,I6X9E2,89.2008285522461
RVBD0979A:rpmF,3,1,2,0,6,RV0979A,P9WH99,93.09789276123047
RVBD3352c:RVBD3352c,4,0,2,0,6,RV3352c,O50381,96.25406646728516
RVBD3765c:tcrX,2,2,2,0,6,RV3765c,O69730,84.19666290283203
RVBD0675:echA5,3,2,1,0,6,RV0675,I6Y4E8,95.17072296142578
RVBD3312c:RVBD3312c,2,2,2,0,6,RV3312c,O53363,94.8313980102539
RVBD0818:RVBD0818,3,1,2,0,6,RV0818,O53830,84.2874526977539
RVBD3305c:amiA1,3,1,2,0,6,RV3305c,L7N663,96.34691619873047
RVBD3328c:sigJ,2,1,3,0,6,RV3328c,L0TCG5,89.90625
RVBD3283:sseA,2,0,4,0,6,RV3283,P9WHF7,96.02265167236328
RVBD3288c:usfY,2,1,3,0,6,RV3288c,L7N685,62.70621109008789
RVBD1502:RVBD1502,4,1,1,0,6,RV1502,P9WLW7,95.01936340332031
RVBD0176:RVBD0176,3,1,2,0,6,RV0176,O07420,88.10658264160156
RVBD2980:RVBD2980,2,0,4,0,6,RV2980,P95115,90.66569519042969
RVBD3630:RVBD3630,2,0,4,0,6,RV3630,P9WKX9,89.09591674804688
RVBD3145:nuoA,2,1,3,0,6,RV3145,P9WIW7,83.51179504394531
RVBD0729:xylB,3,1,2,0,6,RV0729,I6Y4K0,94.09174346923828
RVBD2741:PE-PGRS47,3,2,1,0,6,RV2741,Q79FB3,96.14232635498047
RVBD2371:PE-PGRS40,3,0,3,0,6,RV2371,Q79FE9,90.62326049804688
RVBD1430:PE16,3,1,1,1,6,RV1430,L7N697,74.89471435546875
RVBD3507:PE-PGRS53,4,1,1,0,6,RV3507,Q6MWW9,66.60017395019531
RVBD0311:RVBD0311,2,2,2,0,6,RV0311,O07238,97.17051696777344
RVBD2983:RVBD2983,2,0,4,0,6,RV2983,P9WP83,94.31388854980469
RVBD2653c:RVBD2653c,2,2,2,0,6,RV2653c,P9WJ13,69.26336669921875
RVBD3884c:eccA2,3,1,2,0,6,RV3884c,P9WPH7,93.98910522460938
RVBD2627c:RVBD2627c,3,0,2,1,6,RV2627c,P9WL67,85.20684814453125
RVBD0558:menH,2,1,3,0,6,RV0558,P9WFR3,92.11308288574219
RVBD3843c:RVBD3843c,3,1,2,0,6,RV3843c,P96235,81.01152038574219
RVBD0007:RVBD0007,3,1,1,1,6,RV0007,P9WMA7,59.24848556518555
RVBD0648:RVBD0648,2,1,3,0,6,RV0648,P96937,94.76663208007812
RVBD1328:glgP,3,2,1,0,6,RV1328,P9WMW1,93.65353393554688
RVBD3455c:truA,3,2,1,0,6,RV3455c,P9WHP9,92.64098358154297
RVBD0859:fadA,2,0,4,0,6,RV0859,O53871,97.18397521972656
RVBD1655:argD,2,2,2,0,6,RV1655,P9WPZ7,97.29772186279297
RVBD2747:argA,0,1,4,1,6,RV2747,O33289,92.28373718261719
RVBD0461:RVBD0461,3,0,3,0,6,RV0461,I6X961,60.05218505859375
RVBD2466c:RVBD2466c,2,3,1,0,6,RV2466c,O53193,94.0003433227539
RVBD0860:fadB,3,0,3,0,6,RV0860,O53872,96.55043029785156
RVBD1551:plsB1,3,2,1,0,6,RV1551,P9WI59,89.83097839355469
RVBD3323c:moaX,3,1,2,0,6,RV3323c,Q6MWY3,90.5626449584961
RVBD3616c:espA,3,1,1,1,6,RV3616c,P9WJE1,59.49601745605469
RVBD2024c:RVBD2024c,3,1,2,0,6,RV2024c,O53470,86.57341003417969
RVBD2382c:mbtC,3,2,1,0,6,RV2382c,P71718,94.6420669555664
RVBD2604c:snoP,2,2,2,0,6,RV2604c,P9WII7,95.36091613769531
RVBD2255A:RVBD2255A,2,1,3,0,6,RV2255A,,
RVBD2948c:fadD22,3,1,2,0,6,RV2948c,P9WQ61,83.62642669677734
RVBD0470c:pcaA,2,1,3,0,6,RV0470c,P9WPB3,96.17407989501953
ssr:ssr,4,1,1,0,6,ss,P38656,
RVBD2485c:lipQ,3,1,2,0,6,RV2485c,I6Y9F7,84.1482162475586
RVBD0977:PE-PGRS16,2,2,2,0,6,RV0977,Q79FU3,83.65459442138672
RVBD3274c:fadE25,2,1,3,0,6,RV3274c,P9WQG1,97.36349487304688
RVBD3662c:RVBD3662c,0,0,6,0,6,RV3662c,I6YCP7,93.58734130859375
RVBD3655c:RVBD3655c,1,2,3,0,6,RV3655c,O69623,86.03150939941406
RVBD3658c:RVBD3658c,2,2,2,0,6,RV3658c,I6Y479,81.35075378417969
RVBD3666c:dppA,3,0,2,1,6,RV3666c,I6X811,94.54241943359375
RVBD2962c:RVBD2962c,3,1,2,0,6,RV2962c,P9WN09,87.39144134521484
RVBD0603:RVBD0603,3,1,2,0,6,RV0603,O07775,58.652713775634766
RVBD1375:RVBD1375,3,1,2,0,6,RV1375,P9WF27,86.4197006225586
RVBD3509c:ilvX,3,1,2,0,6,RV3509c,O53554,95.62716674804688
RVBD2724c:fadE20,3,1,2,0,6,RV2724c,O33229,97.12606048583984
RVBD0513:RVBD0513,3,1,2,0,6,RV0513,O33358,79.0146713256836
RVBD0055:rpsR1,3,1,2,0,6,RV0055,P9WH49,84.701904296875
RVBD0433:RVBD0433,2,1,3,0,6,RV0433,P9WPK9,94.95284271240234
RVBD2234:ptpA,2,1,3,0,6,RV2234,P9WIA1,94.3264389038086
RVBD3229c:desA3,3,0,2,1,6,RV3229c,P9WNZ3,93.56925201416016
RVBD1366:RVBD1366,4,1,1,0,6,RV1366,P9WLZ5,87.68951416015625
RVBD6011:tRNA-Asp12,1,1,4,0,6,RV6011,,
RVBD2095c:pafC,2,1,3,0,6,RV2095c,P9WIL9,85.10908508300781
RVBD0274:RVBD0274,2,1,3,0,6,RV0274,O53680,96.0702133178711
RVBD1626:RVBD1626,1,1,4,0,6,RV1626,P9WGM3,88.77745819091797
RVBD2987c:leuD,1,1,4,0,6,RV2987c,P9WK95,96.06071472167969
RVBD1460:RVBD1460,0,2,4,0,6,RV1460,O53151,82.47003173828125
RVBD3237c:RVBD3237c,3,1,2,0,6,RV3237c,O05882,89.40550231933594
RVBD3165c:RVBD3165c,3,1,2,0,6,RV3165c,O53315,77.43794250488281
RVBD0308:RVBD0308,3,0,3,0,6,RV0308,O07235,90.56324005126953
RVBD1305:atpE,1,2,3,0,6,RV1305,P9WPS1,95.28704071044922
RVBD0117:oxyS,3,0,3,0,6,RV0117,L7N677,92.13468170166016
RVBD3703c:RVBD3703c,3,1,2,0,6,RV3703c,O69671,97.1672592163086
RVBD2707:RVBD2707,3,1,2,0,6,RV2707,I6YE67,81.5870132446289
RVBD0331:RVBD0331,3,1,2,0,6,RV0331,O07255,96.61038208007812
RVBD0167:yrbE1A,3,0,3,0,6,RV0167,O07412,85.77044677734375
RVBD0468:fadB2,2,1,3,0,6,RV0468,P9WNP7,97.04510498046875
RVBD0530:RVBD0530,3,1,2,0,6,RV0530,O06396,76.63565826416016
RVBD0292:eccE3,3,0,3,0,6,RV0292,P9WJE5,84.8217544555664
RVBD0950c:RVBD0950c,3,0,3,0,6,RV0950c,P71560,68.95367431640625
RVBD0605:RVBD0605,3,1,2,0,6,RV0605,I6Y890,86.22677612304688
RVBD2214c:ephD,2,1,2,1,6,RV2214c,P9WGS3,92.32608032226562
RVBD1574:RVBD1574,2,1,3,0,6,RV1574,L0TA08,66.30912017822266
RVBD2804c:RVBD2804c,4,0,2,0,6,RV2804c,I6YEE9,52.7043571472168
RVBD1717:RVBD1717,2,2,2,0,6,RV1717,O86372,96.55242156982422
RVBD0834c:PE-PGRS14,3,1,2,0,6,RV0834c,Q79FV6,93.49010467529297
RVBD1414:RVBD1414,2,2,2,0,6,RV1414,P9WLY3,81.4698486328125
RVBD0096:PPE1,3,1,2,0,6,RV0096,P9WI49,67.99021911621094
RVBD1727:RVBD1727,3,0,3,0,6,RV1727,P71985,96.06005096435547
RVBD3900c:RVBD3900c,5,0,1,0,6,RV3900c,O05445,70.41732788085938
RVBD1429:RVBD1429,3,2,1,0,6,RV1429,O06829,88.86801147460938
RVBD1183:mmpL10,4,0,2,0,6,RV1183,P9WJU1,82.1382064819336
RVBD3694c:RVBD3694c,3,1,2,0,6,RV3694c,O69662,87.70054626464844
RVBD2259:mscR,3,0,3,0,6,RV2259,O53533,96.97974395751953
RVBD1339:RVBD1339,4,1,0,1,6,RV1339,P9WGC1,93.99406433105469
RVBD0842:RVBD0842,3,0,3,0,6,RV0842,O53854,85.37623596191406
RVBD3461c:rpmJ,1,1,4,0,6,RV3461c,P9WH89,94.58269500732422
RVBD2240c:RVBD2240c,2,2,2,0,6,RV2240c,P9WLG7,82.65576934814453
RVBD1473:RVBD1473,3,1,2,0,6,RV1473,O53164,86.17915344238281
RVBD1829:RVBD1829,2,1,3,0,6,RV1829,P9WLR5,85.87249755859375
RVBD2670c:RVBD2670c,3,1,2,0,6,RV2670c,I6Y1G3,84.8157730102539
RVBD0734:mapA,2,2,2,0,6,RV0734,P9WK21,96.3915023803711
RVBD2743c:RVBD2743c,2,2,1,0,5,RV2743c,I6YA50,75.40799713134766
RVBD2319c:RVBD2319c,2,1,2,0,5,RV2319c,P9WLB5,84.37451934814453
RVBD0238:RVBD0238,3,1,1,0,5,RV0238,O53661,86.91548919677734
RVBD2380c:mbtE,1,0,3,1,5,RV2380c,I6Y0L1,83.3482437133789
RVBD0907:RVBD0907,2,0,3,0,5,RV0907,O05900,92.62368774414062
RVBD0797:RVBD0797,2,1,2,0,5,RV0797,O07182,87.7315444946289
RVBD0821c:phoY2,2,1,2,0,5,RV0821c,P9WI95,96.62901306152344
RVBD3545c:cyp125,2,2,1,0,5,RV3545c,P9WPP1,94.17774200439453
RVBD1031:kdpC,3,0,2,0,5,RV1031,P9WKF1,95.72265625
RVBD3560c:fadE30,2,0,2,1,5,RV3560c,I6Y3V5,92.47467803955078
RVBD2490c:PE-PGRS43,2,2,1,0,5,RV2490c,Q79FD4,60.510074615478516
RVBD1165:typA,1,1,3,0,5,RV1165,O06563,86.24400329589844
RVBD2533c:nusB,3,1,1,0,5,RV2533c,P9WIV1,92.7210922241211
RVBD3824c:papA1,3,0,2,0,5,RV3824c,P9WIK9,87.02123260498047
RVBD3639c:RVBD3639c,2,2,1,0,5,RV3639c,I6YGU1,38.71287155151367
RVBD2399c:cysT,2,0,3,0,5,RV2399c,P71745,91.63434600830078
RVBD2511:orn,2,1,2,0,5,RV2511,P9WIU1,91.95817565917969
RVBD0620:galK,1,2,2,0,5,RV0620,P9WN63,96.54815673828125
RVBD1020:mfd,2,1,2,0,5,RV1020,P9WMQ5,81.24201202392578
RVBD2584c:apt,3,1,1,0,5,RV2584c,P9WQ07,85.6278305053711
RVBD3485c:RVBD3485c,1,2,2,0,5,RV3485c,O06348,90.5334701538086
RVBD3171c:hpx,2,2,1,0,5,RV3171c,O53321,89.48657989501953
RVBD2277c:RVBD2277c,1,2,2,0,5,RV2277c,P9WLF1,92.71053314208984
RVBD1499:RVBD1499,1,2,2,0,5,RV1499,P71780,45.002952575683594
RVBD0209:RVBD0209,2,1,2,0,5,RV0209,P96391,90.71453857421875
RVBD1607:chaA,3,0,2,0,5,RV1607,O53910,90.70166015625
RVBD1529:fadD24,3,1,1,0,5,RV1529,O53903,89.1947250366211
RVBD0186:bglS,1,1,3,0,5,RV0186,O07430,96.28992462158203
RVBD2262c:RVBD2262c,3,1,1,0,5,RV2262c,O53536,87.85908508300781
RVBD3786c:RVBD3786c,2,2,1,0,5,RV3786c,P9WKW9,85.71221160888672
RVBD0587:yrbE2A,2,1,2,0,5,RV0587,I6Y870,89.38717651367188
RVBD0577:TB27.3,3,1,1,0,5,RV0577,P9WIR3,95.89961242675781
RVBD0099:fadD10,3,0,1,1,5,RV0099,P9WQ55,88.63243103027344
RVBD0194:RVBD0194,3,1,1,0,5,RV0194,O53645,84.62675476074219
rnpB:rnpB,3,2,0,0,5,rn,Q9VI93,
RVBD3544c:fadE28,2,2,1,0,5,RV3544c,P71857,96.90035247802734
RVBD2314c:RVBD2314c,1,2,2,0,5,RV2314c,P71898,96.34675598144531
RVBD1168c:PPE17,1,1,3,0,5,RV1168c,P9WI27,65.9158935546875
RVBD1056:RVBD1056,2,0,1,2,5,RV1056,O53404,95.84385681152344
RVBD3160c:RVBD3160c,3,0,2,0,5,RV3160c,O53310,91.5141830444336
RVBD2946c:pks1,3,0,2,0,5,RV2946c,P96285,87.18916320800781
RVBD3190c:RVBD3190c,2,1,2,0,5,RV3190c,O53336,81.50923919677734
RVBD1765c:RVBD1765c,3,0,2,0,5,RV1765c,O06798,84.2224349975586
RVBD1621c:cydD,3,0,2,0,5,RV1621c,O06138,88.5425796508789
RVBD3366:spoU,2,0,3,0,5,RV3366,O50394,92.6484375
RVBD1758:cut1,3,0,2,0,5,RV1758,O06793,94.2176513671875
RVBD3370c:dnaE2,3,0,0,2,5,RV3370c,P9WNT5,86.8155288696289
RVBD3412:RVBD3412,2,0,3,0,5,RV3412,P9WKY9,85.94647216796875
RVBD1238:sugC,2,1,2,0,5,RV1238,P9WQI3,91.37010955810547
RVBD2224c:caeA,4,0,1,0,5,RV2224c,P9WHR3,94.82601928710938
RVBD0670:end,3,0,2,0,5,RV0670,P9WQ13,97.58114624023438
RVBD0443:RVBD0443,0,0,5,0,5,RV0443,O53728,97.34017181396484
RVBD3498c:mce4B,3,1,1,0,5,RV3498c,I6X7G8,84.08242797851562
RVBD0793:RVBD0793,3,1,1,0,5,RV0793,O86332,96.61515045166016
RVBD3767c:RVBD3767c,2,0,3,0,5,RV3767c,P9WFH5,88.67579650878906
RVBD3579c:RVBD3579c,1,1,2,1,5,RV3579c,P9WFY5,84.59928894042969
RVBD3575c:RVBD3575c,2,1,2,0,5,RV3575c,P96857,93.64217376708984
RVBD0739:RVBD0739,1,2,2,0,5,RV0739,P9WKS1,89.41272735595703
RVBD0078:RVBD0078,1,0,4,0,5,RV0078,O53623,95.42974853515625
RVBD1538c:ansA,2,2,1,0,5,RV1538c,P9WPX5,95.67041015625
RVBD1396c:PE-PGRS25,1,1,3,0,5,RV1396c,P71664,94.67112731933594
RVBD0987:RVBD0987,3,0,2,0,5,RV0987,O53900,81.24691772460938
RVBD0244c:fadE5,0,0,5,0,5,RV0244c,O53666,97.94367218017578
RVBD3588c:canB,2,1,2,0,5,RV3588c,P9WPJ9,96.48159790039062
RVBD1488:RVBD1488,2,3,0,0,5,RV1488,P9WPR9,84.06278228759766
RVBD1691:RVBD1691,2,1,2,0,5,RV1691,O33193,90.98835754394531
RVBD2347c:esxP,2,1,2,0,5,RV2347c,P9WNI5,86.16072082519531
RVBD0768:aldA,2,1,2,0,5,RV0768,I6X9R9,97.50401306152344
RVBD1711:RVBD1711,2,1,2,0,5,RV1711,P9WHQ1,91.90988159179688
RVBD3734c:tgs2,3,1,1,0,5,RV3734c,P9WKC7,86.81671905517578
RVBD0069c:sdaA,2,2,1,0,5,RV0069c,P9WGT5,94.39397430419922
RVBD0567:RVBD0567,3,0,2,0,5,RV0567,O53764,95.4463119506836
RVBD1038c:esxJ,2,1,2,0,5,RV1038c,P9WNJ9,87.36438751220703
RVBD2449c:RVBD2449c,4,1,0,0,5,RV2449c,O53176,92.56055450439453
RVBD2832c:ugpC,2,0,3,0,5,RV2832c,I6X5H3,92.90199279785156
RVBD0534c:menA,1,1,3,0,5,RV0534c,P9WIP3,94.97085571289062
RVBD2063:mazE7,0,2,3,0,5,RV2063,P9WJ85,85.01026153564453
RVBD2729c:RVBD2729c,1,2,2,0,5,RV2729c,O33234,76.12462615966797
RVBD2456c:RVBD2456c,2,1,2,0,5,RV2456c,P9WJX1,87.58403778076172
RVBD0315:RVBD0315,2,1,2,0,5,RV0315,O07242,86.94326782226562
RVBD2866:relG,2,1,2,0,5,RV2866,O33348,94.68161010742188
RVBD2452c:RVBD2452c,4,0,1,0,5,RV2452c,O53179,59.95687484741211
RVBD2377c:mbtH,3,0,1,1,5,RV2377c,P9WIP5,89.48985290527344
RVBD1077:cbs,3,1,1,0,5,RV1077,P9WP51,92.78775787353516
RVBD2434c:RVBD2434c,2,0,2,1,5,RV2434c,P71915,86.74978637695312
RVBD0988:RVBD0988,3,1,1,0,5,RV0988,O86370,90.19984436035156
RVBD3705A:RVBD3705A,4,0,1,0,5,RV3705A,I6YGY9,61.146121978759766
RVBD0681:RVBD0681,2,1,2,0,5,RV0681,O53789,91.58587646484375
RVBD3534c:hsaF,1,2,2,0,5,RV3534c,P9WMK5,97.31141662597656
RVBD0135c:RVBD0135c,3,1,1,0,5,RV0135c,P96812,92.84761047363281
RVBD1197:esxK,2,1,2,0,5,RV1197,P9WNJ7,87.39336395263672
RVBD1097c:RVBD1097c,1,1,3,0,5,RV1097c,O53445,78.92416381835938
RVBD3649:RVBD3649,3,1,1,0,5,RV3649,O06359,90.10143280029297
RVBD0149:RVBD0149,1,1,3,0,5,RV0149,P96826,95.53810119628906
RVBD0713:RVBD0713,1,2,2,0,5,RV0713,I6WZ58,82.44032287597656
RVBD1588c:RVBD1588c,5,0,0,0,5,RV1588c,P9WLT9,79.78103637695312
RVBD2571c:RVBD2571c,3,0,2,0,5,RV2571c,P9WL89,88.33721160888672
RVBD3314c:deoA,2,0,3,0,5,RV3314c,P9WFS1,95.07372283935547
RVBD0839:RVBD0839,1,2,2,0,5,RV0839,I6X9X6,93.30484771728516
RVBD1820:ilvG,1,2,2,0,5,RV1820,P9WG39,95.32078552246094
RVBD3678c:RVBD3678c,2,2,1,0,5,RV3678c,I6YGW9,96.74946594238281
RVBD2720:lexA,2,0,3,0,5,RV2720,P9WHR7,77.38835906982422
RVBD1001:arcA,3,2,0,0,5,RV1001,P9WQ05,93.17216491699219
RVBD3382c:lytB1,3,1,1,0,5,RV3382c,P9WKF9,94.3806381225586
RVBD2637:dedA,1,1,3,0,5,RV2637,P9WP07,83.44459533691406
RVBD3140:fadE23,3,0,1,1,5,RV3140,P95186,90.31063079833984
RVBD2680:RVBD2680,1,0,4,0,5,RV2680,O86317,86.06275939941406
RVBD3827c:RVBD3827c,2,1,2,0,5,RV3827c,O07796,85.92700958251953
RVBD2180c:RVBD2180c,3,1,1,0,5,RV2180c,O53514,78.78085327148438
RVBD3397c:phyA,1,1,3,0,5,RV3397c,P9WHP3,91.8681411743164
RVBD3797:fadE35,2,0,3,0,5,RV3797,O53577,93.6277084350586
RVBD3320c:vapC44,1,2,2,0,5,RV3320c,P9WF53,97.49781036376953
RVBD2017:RVBD2017,0,2,2,1,5,RV2017,O53463,89.58386993408203
RVBD2320c:rocE,2,0,3,0,5,RV2320c,P71892,87.65579986572266
RVBD0340:RVBD0340,2,1,2,0,5,RV0340,O33270,52.550498962402344
RVBD3511:PE-PGRS55,3,0,2,0,5,RV3511,Q6MWW8,90.75874328613281
RVBD2861c:mapB,2,0,3,0,5,RV2861c,P9WK19,97.38887786865234
RVBD1770:RVBD1770,1,1,1,2,5,RV1770,O06803,91.21920776367188
RVBD1508A:RVBD1508A,3,1,1,0,5,RV1508A,Q79FN0,58.776588439941406
RVBD1485:hemZ,1,1,2,0,4,RV1485,P9WNE3,92.6131362915039
RVBD3820c:papA2,1,1,2,0,4,RV3820c,P9WIK7,96.23085021972656
RVBD3813c:RVBD3813c,0,2,2,0,4,RV3813c,O07810,96.28113555908203
RVBD3010c:pfkA,2,1,1,0,4,RV3010c,P9WID7,96.32366943359375
RVBD2982c:gpdA2,2,1,1,0,4,RV2982c,P9WN77,93.90287780761719
RVBD2952:RVBD2952,3,1,0,0,4,RV2952,P9WIN3,87.61451721191406
RVBD0940c:RVBD0940c,2,0,2,0,4,RV0940c,P9WKP1,96.48773956298828
RVBD0838:lpqR,1,1,2,0,4,RV0838,O53850,87.23128509521484
RVBD2830c:vapB22,2,1,1,0,4,RV2830c,P71622,89.71661376953125
RVBD1009:rpfB,2,0,2,0,4,RV1009,P9WG29,94.49557495117188
RVBD0922:RVBD0922,2,0,1,1,4,RV0922,I6Y560,86.2912368774414
RVBD0110:RVBD0110,2,1,1,0,4,RV0110,O53632,93.73505401611328
RVBD1215c:RVBD1215c,3,1,0,0,4,RV1215c,O05316,95.7750244140625
RVBD3144c:PPE52,1,0,3,0,4,RV3144c,I6X6H8,61.80995178222656
RVBD0045c:RVBD0045c,1,1,2,0,4,RV0045c,I6XU97,94.18895721435547
RVBD0672:fadE8,3,0,1,0,4,RV0672,I6X9J0,97.2141342163086
RVBD3287c:rsbW,2,0,2,0,4,RV3287c,P9WGX7,82.03482055664062
RVBD1554:frdC,2,0,1,1,4,RV1554,P9WNB7,93.05651092529297
RVBD1971:mce3F,1,1,2,0,4,RV1971,O53972,85.38953399658203
RVBD3343c:PPE54,2,0,2,0,4,RV3343c,Q6MWY2,49.42763900756836
RVBD1990c:RVBD1990c,1,0,3,0,4,RV1990c,P9WLP7,94.82716369628906
RVBD1737c:narK2,2,0,2,0,4,RV1737c,P9WJY7,92.88047790527344
RVBD2559c:RVBD2559c,3,0,1,0,4,RV2559c,P9WQN1,86.36029052734375
RVBD0451c:mmpS4,3,0,1,0,4,RV0451c,P9WJS9,84.82757568359375
RVBD0628c:RVBD0628c,1,1,2,0,4,RV0628c,P9WKS7,95.00214385986328
RVBD1872c:lldD2,3,1,0,0,4,RV1872c,P9WND5,90.32589721679688
RVBD3169:RVBD3169,2,0,1,1,4,RV3169,O53319,95.7177505493164
RVBD3024c:trmU,1,1,2,0,4,RV3024c,P9WJS5,91.95378112792969
RVBD3568c:hsaC,3,0,1,0,4,RV3568c,P9WNW7,96.4340591430664
RVBD0474:RVBD0474,2,2,0,0,4,RV0474,P9WMH9,83.57743072509766
RVBD1489A:RVBD1489A,2,1,1,0,4,RV1489A,L7N6A8,85.14789581298828
RVBD2427c:proA,2,1,1,0,4,RV2427c,P9WHV1,95.50159454345703
RVBD0653c:RVBD0653c,2,2,0,0,4,RV0653c,P96941,93.22164916992188
RVBD0185:RVBD0185,1,0,3,0,4,RV0185,O07429,92.45490264892578
RVBD2175c:RVBD2175c,1,1,2,0,4,RV2175c,O53509,80.20088958740234
RVBD0115:hddA,3,0,1,0,4,RV0115,O53637,88.83326721191406
RVBD3659c:RVBD3659c,2,0,2,0,4,RV3659c,P9WMT3,91.68443298339844
RVBD2045c:lipT,2,1,1,0,4,RV2045c,O53488,93.09859466552734
RVBD0754:PE-PGRS11,3,0,1,0,4,RV0754,Q79FW5,85.90768432617188
RVBD3743c:ctpJ,1,1,2,0,4,RV3743c,P9WPT7,84.44425964355469
RVBD2508c:RVBD2508c,1,1,2,0,4,RV2508c,O06171,88.7074203491211
RVBD1656:argF,3,0,1,0,4,RV1656,P9WIT9,97.02654266357422
RVBD1153c:omt,3,1,0,0,4,RV1153c,O06551,90.81446838378906
RVBD3179:RVBD3179,2,1,1,0,4,RV3179,O53329,93.74768829345703
RVBD1956:higA,1,1,2,0,4,RV1956,P9WJA7,74.56549835205078
RVBD0233:nrdB,2,0,2,0,4,RV0233,P9WH69,95.82821655273438
RVBD3200c:RVBD3200c,2,0,2,0,4,RV3200c,O53346,86.99430847167969
RVBD0229c:RVBD0229c,2,0,2,0,4,RV0229c,L0T5V6,96.56021881103516
RVBD2582:ppiB,2,1,1,0,4,RV2582,P9WHW1,87.90928649902344
RVBD0463:RVBD0463,1,0,3,0,4,RV0463,O53748,67.20113372802734
RVBD2286c:RVBD2286c,1,1,2,0,4,RV2286c,P9WLE7,93.25969696044922
RVBD3224:RVBD3224,2,1,1,0,4,RV3224,O05842,96.77198028564453
RVBD2517c:RVBD2517c,2,0,0,2,4,RV2517c,O53222,76.9154281616211
RVBD3515c:fadD19,3,0,1,0,4,RV3515c,P9WQ51,91.5549087524414
RVBD1961:RVBD1961,2,2,0,0,4,RV1961,P95253,64.34786987304688
RVBD1510:RVBD1510,2,0,2,0,4,RV1510,P9WLW1,88.9737777709961
RVBD1054:RVBD1054,1,1,2,0,4,RV1054,O53402,67.13673400878906
RVBD3746c:PE34,1,1,2,0,4,RV3746c,Q79FA1,87.03729248046875
RVBD0556:RVBD0556,3,0,0,1,4,RV0556,O06422,86.64269256591797
RVBD0374c:RVBD0374c,2,1,1,0,4,RV0374c,O53709,95.88925170898438
RVBD2475c:RVBD2475c,2,0,2,0,4,RV2475c,I6Y9E8,96.1155776977539
RVBD2081c:RVBD2081c,2,0,1,1,4,RV2081c,P9WLK5,33.276573181152344
RVBD1115:RVBD1115,2,1,1,0,4,RV1115,O06567,76.17214965820312
RVBD3003c:ilvB1,1,1,2,0,4,RV3003c,P9WG41,92.9012451171875
RVBD0072:RVBD0072,2,1,1,0,4,RV0072,P9WG17,90.61888122558594
RVBD2756c:hsdM,3,0,1,0,4,RV2756c,O33298,90.69544219970703
RVBD3104c:RVBD3104c,2,0,2,0,4,RV3104c,O05781,85.89627075195312
RVBD3194c:RVBD3194c,4,0,0,0,4,RV3194c,O53340,93.04108428955078
RVBD3614c:espD,2,0,2,0,4,RV3614c,P9WJD5,74.57521057128906
RVBD3677c:RVBD3677c,2,0,1,1,4,RV3677c,I6XHY3,95.27333068847656
RVBD1682:RVBD1682,2,1,1,0,4,RV1682,O33184,84.59675598144531
RVBD3726:RVBD3726,1,2,1,0,4,RV3726,O69693,94.57727813720703
RVBD1200:RVBD1200,2,0,2,0,4,RV1200,O05301,91.22575378417969
RVBD0962c:lprP,2,1,1,0,4,RV0962c,P9WK39,81.09794616699219
RVBD0800:pepC,2,1,1,0,4,RV0800,P9WHT1,94.66236114501953
RVBD1494:mazE4,3,0,1,0,4,RV1494,P9WJ91,86.86119842529297
RVBD0153c:ptbB,2,0,2,0,4,RV0153c,I6WXK4,86.34329986572266
RVBD0663:atsD,1,1,2,0,4,RV0663,I6XVW9,94.125
RVBD1062:RVBD1062,0,2,2,0,4,RV1062,O53410,95.7284164428711
RVBD0975c:fadE13,1,1,2,0,4,RV0975c,O86319,98.02384948730469
RVBD1540:RVBD1540,3,0,1,0,4,RV1540,P9WHQ3,94.26509857177734
RVBD0847:lpqS,3,0,1,0,4,RV0847,O53859,66.28569793701172
RVBD0219:RVBD0219,1,1,2,0,4,RV0219,P96401,84.44384002685547
RVBD2567:RVBD2567,0,1,3,0,4,RV2567,P9WL97,88.76434326171875
RVBD0427c:xthA,1,2,1,0,4,RV0427c,P96273,93.64436340332031
RVBD0745:RVBD0745,1,1,2,0,4,RV0745,I6X9N8,57.24932098388672
RVBD0174:mce1F,2,1,1,0,4,RV0174,L0T2W6,81.34483337402344
RVBD0908:ctpE,3,1,0,0,4,RV0908,P9WPT1,85.74589538574219
RVBD0696:RVBD0696,1,0,3,0,4,RV0696,P9WMX1,91.05587005615234
RVBD1091:PE-PGRS22,0,2,2,0,4,RV1091,Q79FS5,91.10298919677734
RVBD0133:RVBD0133,1,2,1,0,4,RV0133,P96810,93.59616088867188
RVBD3342:RVBD3342,1,0,3,0,4,RV3342,P9WK01,90.48868560791016
RVBD0035:fadD34,1,1,2,0,4,RV0035,L7N699,85.29888916015625
RVBD2144c:RVBD2144c,3,0,0,1,4,RV2144c,O06231,66.12017822265625
RVBD0363c:fba,0,2,2,0,4,RV0363c,P9WQA3,93.60932922363281
RVBD2470:glbO,2,0,2,0,4,RV2470,P9WN23,96.63679504394531
RVBD2727c:miaA,1,1,2,0,4,RV2727c,P9WJW1,94.63751220703125
RVBD1582c:RVBD1582c,1,1,2,0,4,RV1582c,O06608,88.28564453125
RVBD0344c:lpqJ,2,0,2,0,4,RV0344c,O06295,81.58328247070312
RVBD0252:nirB,1,1,2,0,4,RV0252,O53674,90.70673370361328
RVBD3347c:PPE55,1,0,3,0,4,RV3347c,Q6MWX9,
RVBD2530A:vapB39,2,0,2,0,4,RV2530A,P9WJ23,90.99121856689453
RVBD1646:PE17,2,0,2,0,4,RV1646,L7N681,75.71038055419922
RVBD1275:lprC,2,0,2,0,4,RV1275,O86337,88.24866485595703
RVBD1606:hisI,0,2,1,1,4,RV1606,P9WMM7,97.47444152832031
RVBD0147:RVBD0147,1,1,2,0,4,RV0147,P96824,91.0993881225586
RVBD2397c:cysA1,2,0,2,0,4,RV2397c,P9WQM1,89.11438751220703
RVBD2138:lppL,1,0,2,1,4,RV2138,O06237,89.97187042236328
RVBD0694:lldD1,2,1,1,0,4,RV0694,P9WND7,93.94325256347656
RVBD3139:fadE24,1,0,3,0,4,RV3139,P95187,87.44741821289062
RVBD1019:RVBD1019,2,0,2,0,4,RV1019,P96381,91.67877197265625
RVBD1057:RVBD1057,3,0,1,0,4,RV1057,O53405,81.12162780761719
RVBD3661:RVBD3661,2,1,1,0,4,RV3661,P9WGJ1,81.87540435791016
RVBD2432c:RVBD2432c,2,1,1,0,4,RV2432c,P71917,30.925073623657227
RVBD2568c:RVBD2568c,2,0,2,0,4,RV2568c,P9WL95,91.1958999633789
RVBD1517:RVBD1517,1,1,2,0,4,RV1517,P71796,68.68074798583984
RVBD2701c:suhB,1,2,1,0,4,RV2701c,P9WKI9,90.79427337646484
RVBD3427c:RVBD3427c,1,2,1,0,4,RV3427c,Q50701,91.52143096923828
RVBD1665:pks11,2,0,2,0,4,RV1665,P9WPF3,97.40773010253906
RVBD3570c:hsaA,2,0,2,0,4,RV3570c,P9WJA1,96.76602172851562
RVBD2840c:RVBD2840c,1,1,2,0,4,RV2840c,I6XFF7,88.63140869140625
RVBD2401:RVBD2401,2,0,2,0,4,RV2401,O86326,50.17054748535156
RVBD2134c:RVBD2134c,1,0,3,0,4,RV2134c,O06241,85.0117416381836
RVBD2897c:RVBD2897c,3,0,1,0,4,RV2897c,P9WPR1,90.53662109375
RVBD2888c:amiC,1,2,1,0,4,RV2888c,P9WQ95,95.7965087890625
RVBD1188:RVBD1188,2,1,1,0,4,RV1188,O50444,87.54212951660156
RVBD1404:RVBD1404,0,0,4,0,4,RV1404,P71672,89.56531524658203
RVBD1134:RVBD1134,1,0,2,1,4,RV1134,O06534,48.78756332397461
RVBD0894:RVBD0894,2,0,2,0,4,RV0894,P9WKP9,83.01786804199219
RVBD1367c:RVBD1367c,2,1,1,0,4,RV1367c,P9WLZ3,95.39939880371094
RVBD1664:pks9,2,0,2,0,4,RV1664,O06586,89.21672058105469
RVBD0499:RVBD0499,3,0,1,0,4,RV0499,P9WKT9,92.5156021118164
RVBD0607:RVBD0607,2,1,1,0,4,RV0607,O07771,82.41586303710938
RVBD3419c:gcp,2,0,2,0,4,RV3419c,P9WHT7,96.68075561523438
RVBD0386:RVBD0386,2,1,1,0,4,RV0386,O53720,87.82809448242188
RVBD2091c:RVBD2091c,2,0,2,0,4,RV2091c,P9WLJ5,59.18635559082031
RVBD0187:RVBD0187,2,1,1,0,4,RV0187,O07431,96.21532440185547
RVBD3476c:kgtP,1,1,2,0,4,RV3476c,I6XHB8,85.73600769042969
RVBD2469c:RVBD2469c,2,1,1,0,4,RV2469c,O53196,78.99571228027344
RVBD2062c:cobN,2,1,1,0,4,RV2062c,O53498,91.52214050292969
RVBD0819:mshD,3,0,1,0,4,RV0819,P9WJM7,91.88021850585938
RVBD0432:sodC,2,0,2,0,4,RV0432,P9WGE9,86.62000274658203
RVBD0981:mprA,2,0,2,0,4,RV0981,P9WGM9,89.24891662597656
RVBD1777:cyp144,3,0,1,0,4,RV1777,P9WPL1,92.32090759277344
RVBD0119:fadD7,2,0,2,0,4,RV0119,O07169,88.24005889892578
RVBD3542c:RVBD3542c,3,0,1,0,4,RV3542c,I6YGF8,92.51797485351562
RVBD3202c:RVBD3202c,2,0,2,0,4,RV3202c,O53348,84.91694641113281
RVBD1511:gmdA,2,0,2,0,4,RV1511,P71790,96.00161743164062
RVBD3068c:pgmA,1,1,2,0,4,RV3068c,I6Y2G3,96.3508529663086
RVBD0222:echA1,2,1,1,0,4,RV0222,P96404,95.71985626220703
RVBD0982:mprB,2,0,2,0,4,RV0982,P9WGL1,84.45799255371094
RVBD0877:RVBD0877,3,1,0,0,4,RV0877,P9WKR3,88.96129608154297
RVBD0144:RVBD0144,2,1,1,0,4,RV0144,P96821,75.25196838378906
RVBD0507:mmpL2,2,0,2,0,4,RV0507,P9WJV7,84.51293182373047
RVBD0561c:RVBD0561c,2,0,2,0,4,RV0561c,P9WNY9,91.38507080078125
RVBD2775:RVBD2775,1,1,2,0,4,RV2775,O33317,87.71300506591797
RVBD0858c:dapC,2,1,1,0,4,RV0858c,P9WPZ5,96.21053314208984
RVBD3299c:atsB,1,1,1,1,4,RV3299c,O65931,89.52068328857422
RVBD3006:lppZ,3,0,1,0,4,RV3006,I6Y293,88.7212142944336
RVBD2551c:RVBD2551c,0,0,2,2,4,RV2551c,I6Y9M6,89.44784545898438
RVBD3685c:cyp137,2,0,2,0,4,RV3685c,P9WPM5,88.30330657958984
RVBD1493:mutB,2,0,2,0,4,RV1493,P9WJK5,94.38257598876953
RVBD2489c:RVBD2489c,1,1,2,0,4,RV2489c,O53214,47.082027435302734
RVBD2410c:RVBD2410c,3,0,1,0,4,RV2410c,P71733,89.0028305053711
RVBD3879c:espK,3,0,1,0,4,RV3879c,P9WJC1,70.49610137939453
RVBD3586:RVBD3586,1,0,2,1,4,RV3586,P9WNW5,94.5826644897461
RVBD3500c:yrbE4B,2,1,1,0,4,RV3500c,I6Y3P5,87.05307006835938
RVBD2738c:RVBD2738c,1,1,2,0,4,RV2738c,I6YA47,92.02250671386719
RVBD0088:RVBD0088,0,1,3,0,4,RV0088,P9WM73,78.31080627441406
RVBD2197c:RVBD2197c,3,0,1,0,4,RV2197c,P9WLI9,58.47883605957031
RVBD0306:RVBD0306,2,1,1,0,4,RV0306,O07233,95.59376525878906
RVBD1469:ctpD,1,2,1,0,4,RV1469,P9WPT3,83.86000061035156
RVBD1707:RVBD1707,3,0,1,0,4,RV1707,O33206,89.25874328613281
RVBD1618:tesB1,2,2,0,0,4,RV1618,O06135,93.70380401611328
RVBD3446c:RVBD3446c,1,1,2,0,4,RV3446c,O06263,87.19657135009766
RVBD2758c:vapB21,2,1,1,0,4,RV2758c,P9WJ43,85.96568298339844
RVBD1790:PPE27,1,0,3,0,4,RV1790,Q79FK5,70.40665435791016
RVBD0128:RVBD0128,2,1,1,0,4,RV0128,P96805,84.46154022216797
RVBD0332:RVBD0332,1,1,2,0,4,RV0332,O07256,95.27816009521484
RVBD0184:RVBD0184,1,0,2,1,4,RV0184,O07428,86.79914855957031
RVBD1133c:metE,0,1,2,1,4,RV1133c,P9WK07,95.14015197753906
RVBD1132:RVBD1132,2,0,2,0,4,RV1132,O06583,93.77377319335938
RVBD1704c:cycA,1,1,2,0,4,RV1704c,O33203,80.54804229736328
RVBD1078:pra,2,0,2,0,4,RV1078,P9WIM7,83.25187683105469
RVBD2685:arsB1,2,1,1,0,4,RV2685,P9WPD7,92.32852935791016
RVBD0901:RVBD0901,2,1,1,0,4,RV0901,P9WJG5,67.83085632324219
RVBD3869:eccB1,3,0,1,0,4,RV3869,P9WNR7,90.79865264892578
RVBD2205c:RVBD2205c,1,1,2,0,4,RV2205c,P9WMT7,89.88584899902344
RVBD2617c:RVBD2617c,3,0,1,0,4,RV2617c,I6XER9,90.78041076660156
RVBD3156:nuoL,3,0,0,1,4,RV3156,P9WIW1,93.60787963867188
RVBD1196:PPE18,1,1,1,0,3,RV1196,L7N675,68.98725891113281
RVBD3698:RVBD3698,1,0,2,0,3,RV3698,I6YCS6,93.80693817138672
RVBD0814c:sseC2,1,0,2,0,3,RV0814c,P0CG95,91.44338989257812
RVBD3465:rmlC,2,0,1,0,3,RV3465,P9WH11,97.89569091796875
RVBD1330c:pncB1,1,0,2,0,3,RV1330c,P9WJI9,93.81553649902344
RVBD3621c:PPE65,0,2,1,0,3,RV3621c,P9WHX3,67.51181030273438
RVBD0958:RVBD0958,2,0,1,0,3,RV0958,P71552,92.83594512939453
RVBD3829c:RVBD3829c,2,0,1,0,3,RV3829c,O07794,93.56707000732422
RVBD0969:ctpV,2,0,1,0,3,RV0969,P9WPS3,82.11903381347656
RVBD3684:RVBD3684,1,1,1,0,3,RV3684,O69652,95.54132843017578
RVBD2625c:RVBD2625c,1,1,1,0,3,RV2625c,P9WHR1,88.92951202392578
RVBD1212c:glgA,2,1,0,0,3,RV1212c,P9WMZ1,96.59196472167969
RVBD3228:RVBD3228,1,0,2,0,3,RV3228,O05873,83.7600326538086
RVBD2495c:bkdC,2,0,1,0,3,RV2495c,O06159,85.3843765258789
RVBD1648:RVBD1648,2,1,0,0,3,RV1648,P94983,90.39582824707031
RVBD0893c:RVBD0893c,0,1,2,0,3,RV0893c,P9WFI1,89.828857421875
RVBD1768:PE-PGRS31,1,0,2,0,3,RV1768,Q79FK9,92.58645629882812
RVBD1760:RVBD1760,1,0,2,0,3,RV1760,P9WKB9,81.82943725585938
RVBD3151:nuoG,3,0,0,0,3,RV3151,P9WIV9,94.22782897949219
RVBD0569:RVBD0569,2,0,1,0,3,RV0569,P9WM83,74.2420425415039
RVBD1671:RVBD1671,1,0,2,0,3,RV1671,O53918,70.03799438476562
RVBD1850:ureC,3,0,0,0,3,RV1850,P9WFF1,96.88431549072266
RVBD0097:RVBD0097,1,0,2,0,3,RV0097,P9WG83,94.42041778564453
RVBD0724:sppA,1,0,2,0,3,RV0724,P95072,81.73014068603516
RVBD1125:RVBD1125,2,1,0,0,3,RV1125,O06577,95.510498046875
RVBD0447c:ufaA1,2,0,1,0,3,RV0447c,O53732,89.67829132080078
RVBD3697c:vapC48,3,0,0,0,3,RV3697c,P9WF47,96.39469146728516
RVBD3027c:RVBD3027c,2,1,0,0,3,RV3027c,I6YEZ8,86.76384735107422
RVBD1417:RVBD1417,2,0,1,0,3,RV1417,P9WLY1,91.93792724609375
RVBD2048c:pks12,3,0,0,0,3,RV2048c,I6XD69,
RVBD3761c:fadE36,1,1,1,0,3,RV3761c,O69727,92.37735748291016
RVBD3234c:tgs3,2,0,1,0,3,RV3234c,P9WKC5,81.99505615234375
RVBD0166:fadD5,2,0,1,0,3,RV0166,O07411,88.57005310058594
RVBD1747:RVBD1747,2,0,1,0,3,RV1747,O65934,80.16913604736328
RVBD0356c:RVBD0356c,2,1,0,0,3,RV0356c,O06307,92.53607940673828
RVBD3593:lpqF,3,0,0,0,3,RV3593,O06155,91.06400299072266
RVBD2949c:RVBD2949c,2,1,0,0,3,RV2949c,P9WIC5,81.02699279785156
RVBD0129c:fbpC,3,0,0,0,3,RV0129c,P9WQN9,87.65241241455078
RVBD0695:RVBD0695,1,1,1,0,3,RV0695,P9WP59,93.31150817871094
RVBD3680:RVBD3680,1,0,2,0,3,RV3680,I6Y498,83.48960876464844
RVBD1158c:RVBD1158c,3,0,0,0,3,RV1158c,O06556,55.3619384765625
RVBD3322c:RVBD3322c,1,1,1,0,3,RV3322c,L7N687,93.8877944946289
RVBD3692:moxR2,3,0,0,0,3,RV3692,I6YGX9,87.98440551757812
RVBD2414c:RVBD2414c,2,1,0,0,3,RV2414c,P71729,85.60165405273438
RVBD2023c:RVBD2023c,1,2,0,0,3,RV2023c,O53469,50.46781921386719
RVBD1435c:RVBD1435c,0,0,3,0,3,RV1435c,O06823,58.80812072753906
RVBD0472c:RVBD0472c,2,0,1,0,3,RV0472c,P9WMD9,91.19114685058594
RVBD0156:pntAb,3,0,0,0,3,RV0156,P96833,92.18890380859375
RVBD1362c:RVBD1362c,1,1,1,0,3,RV1362c,P9WM01,77.50955200195312
RVBD1147:RVBD1147,2,0,1,0,3,RV1147,O06547,92.7511215209961
RVBD1592c:RVBD1592c,3,0,0,0,3,RV1592c,P9WK89,92.79668426513672
RVBD1861:RVBD1861,1,1,1,0,3,RV1861,P95154,70.05435180664062
RVBD2809:RVBD2809,1,1,1,0,3,RV2809,I6YEF3,78.64649963378906
RVBD2299c:htpG,2,0,1,0,3,RV2299c,P9WMJ7,87.45819091796875
RVBD1227c:RVBD1227c,1,1,1,0,3,RV1227c,O33223,88.15756225585938
RVBD0959:RVBD0959,1,0,2,0,3,RV0959,P9WKN1,83.97183990478516
RVBD2920c:amt,1,1,1,0,3,RV2920c,P9WQ65,92.9526138305664
RVBD1533:RVBD1533,2,1,0,0,3,RV1533,O06179,93.52397918701172
RVBD2383c:mbtB,1,0,2,0,3,RV2383c,P9WQ63,84.48163604736328
RVBD0202c:mmpL11,3,0,0,0,3,RV0202c,P9WJT9,80.4142074584961
RVBD3413c:RVBD3413c,3,0,0,0,3,RV3413c,P9WJ71,61.73277282714844
RVBD1823:RVBD1823,1,0,1,1,3,RV1823,P9WFG1,83.73309326171875
RVBD0826:RVBD0826,1,1,1,0,3,RV0826,O53837,87.30010986328125
RVBD3641c:fic,2,0,1,0,3,RV3641c,I6YCN3,95.60753631591797
RVBD2405:RVBD2405,0,1,2,0,3,RV2405,P71738,81.34745788574219
RVBD1769:RVBD1769,1,1,1,0,3,RV1769,O06802,94.1203384399414
RVBD0673:echA4,2,1,0,0,3,RV0673,I6Y8F2,94.42903900146484
RVBD3903c:RVBD3903c,2,0,1,0,3,RV3903c,O05442,65.27113342285156
RVBD0414c:thiE,0,2,1,0,3,RV0414c,P9WG75,95.45301818847656
RVBD0574c:RVBD0574c,2,0,1,0,3,RV0574c,P9WM79,94.79623413085938
RVBD0502:RVBD0502,2,0,1,0,3,RV0502,P9WKT1,81.57011413574219
RVBD1276c:RVBD1276c,1,1,1,0,3,RV1276c,P9WGF9,97.7080307006836
RVBD0658c:RVBD0658c,3,0,0,0,3,RV0658c,O06781,93.26100158691406
RVBD3758c:proV,1,0,2,0,3,RV3758c,O69724,87.6115951538086
RVBD0067c:RVBD0067c,2,1,0,0,3,RV0067c,O53612,90.90021514892578
RVBD1156:RVBD1156,1,0,1,1,3,RV1156,O06554,95.52123260498047
RVBD1791:PE19,2,0,1,0,3,RV1791,Q79FK4,95.90324401855469
RVBD1008:tatD,1,0,2,0,3,RV1008,O08343,97.1515121459961
RVBD0143c:RVBD0143c,2,0,1,0,3,RV0143c,P96820,91.52014923095703
RVBD0480c:RVBD0480c,2,1,0,0,3,RV0480c,P9WJ01,92.62474822998047
RVBD2307A:RVBD2307A,1,0,2,0,3,RV2307A,L7N678,55.214599609375
RVBD3196A:RVBD3196A,1,1,0,1,3,RV3196A,L7N668,73.24832916259766
RVBD0602c:tcrA,2,0,1,0,3,RV0602c,O07776,76.85616302490234
RVBD3409c:choD,1,1,1,0,3,RV3409c,P9WMV9,94.49166107177734
RVBD2287:yjcE,2,0,0,1,3,RV2287,P9WJI3,87.46007537841797
RVBD2887:RVBD2887,3,0,0,0,3,RV2887,P9WME9,92.76409912109375
RVBD2378c:mbtG,0,1,1,1,3,RV2378c,P9WKF7,91.24169921875
RVBD0643c:mmaA3,3,0,0,0,3,RV0643c,P0CH91,93.26258850097656
RVBD2509:RVBD2509,1,0,2,0,3,RV2509,I6Y9I3,92.13619232177734
RVBD2975c:RVBD2975c,1,0,2,0,3,RV2975c,P95120,91.16595458984375
RVBD3195:RVBD3195,0,0,3,0,3,RV3195,O53341,78.81861114501953
RVBD0146:RVBD0146,1,0,1,1,3,RV0146,P9WFJ3,87.78157806396484
RVBD1129c:RVBD1129c,2,0,0,1,3,RV1129c,O06581,87.59637451171875
RVBD0367c:RVBD0367c,1,1,1,0,3,RV0367c,O53702,90.374267578125
RVBD1225c:RVBD1225c,2,1,0,0,3,RV1225c,O33221,95.15278625488281
RVBD0106:RVBD0106,1,1,1,0,3,RV0106,P9WPI5,90.77277374267578
RVBD1442:bisC,2,0,1,0,3,RV1442,O06817,97.24446868896484
RVBD1700:RVBD1700,1,0,2,0,3,RV1700,I6X235,96.05525970458984
RVBD1842c:RVBD1842c,3,0,0,0,3,RV1842c,P9WFP3,86.31844329833984
RVBD0169:mce1A,1,0,2,0,3,RV0169,Q79FZ9,75.06493377685547
RVBD1067c:PE-PGRS19,2,1,0,0,3,RV1067c,Q79FT3,95.64703369140625
RVBD1069c:RVBD1069c,2,0,1,0,3,RV1069c,O53417,88.05838012695312
RVBD3348:RVBD3348,0,1,2,0,3,RV3348,P96234,88.35919952392578
RVBD0210:RVBD0210,2,1,0,0,3,RV0210,P96392,85.60877990722656
RVBD1450c:PE-PGRS27,1,2,0,0,3,RV1450c,Q79FP2,69.88639831542969
RVBD0747:PE-PGRS10,1,0,1,1,3,RV0747,P9WIG1,84.85997772216797
RVBD3168:RVBD3168,2,0,1,0,3,RV3168,P9WI99,92.4268798828125
RVBD1364c:RVBD1364c,3,0,0,0,3,RV1364c,P9WLZ7,87.78009796142578
RVBD1692:RVBD1692,3,0,0,0,3,RV1692,O33194,92.72969055175781
RVBD0197:RVBD0197,1,0,2,0,3,RV0197,L0T2Z1,94.4585189819336
RVBD0318c:RVBD0318c,1,1,1,0,3,RV0318c,Q6MX47,87.73897552490234
RVBD1781c:malQ,1,1,1,0,3,RV1781c,P9WK23,94.84342956542969
RVBD3591c:RVBD3591c,2,0,1,0,3,RV3591c,I6YGL1,93.76957702636719
RVBD2947c:pks15,3,0,0,0,3,RV2947c,P96284,91.73320770263672
RVBD3839:RVBD3839,2,0,1,0,3,RV3839,P96239,89.62814331054688
RVBD2159c:RVBD2159c,2,1,0,0,3,RV2159c,O06218,95.8260498046875
RVBD1566c:RVBD1566c,3,0,0,0,3,RV1566c,O06624,77.01725769042969
RVBD1359:RVBD1359,2,0,1,0,3,RV1359,P9WM05,68.05884552001953
RVBD2974c:RVBD2974c,2,0,1,0,3,RV2974c,I6Y259,87.91355895996094
RVBD3592:mhuD,1,1,1,0,3,RV3592,P9WKH3,90.49589538574219
RVBD3049c:RVBD3049c,1,0,2,0,3,RV3049c,I6Y2E2,90.14967346191406
RVBD2325c:RVBD2325c,2,0,1,0,3,RV2325c,P9WPI7,82.4813461303711
RVBD2605c:tesB2,3,0,0,0,3,RV2605c,I6X4S7,90.8406753540039
RVBD1978:RVBD1978,1,1,1,0,3,RV1978,O53979,89.79084777832031
RVBD3152:nuoH,3,0,0,0,3,RV3152,P9WIX1,84.0732192993164
RVBD3864:espE,2,0,1,0,3,RV3864,P9WJD3,60.01589584350586
RVBD0316:RVBD0316,2,0,1,0,3,RV0316,O07243,92.61328887939453
RVBD0381c:RVBD0381c,1,0,2,0,3,RV0381c,O53716,89.29801177978516
RVBD1084:RVBD1084,1,0,2,0,3,RV1084,O53432,94.31952667236328
RVBD3157:nuoM,2,0,1,0,3,RV3157,P9WIW5,91.03459167480469
RVBD0570:nrdZ,1,0,2,0,3,RV0570,P9WH77,89.29975891113281
RVBD3005c:RVBD3005c,3,0,0,0,3,RV3005c,I6YAV3,72.79006958007812
RVBD3230c:RVBD3230c,2,0,1,0,3,RV3230c,P9WNE9,84.12274169921875
RVBD0671:lpqP,2,0,1,0,3,RV0671,I6XVY0,92.54293060302734
RVBD3710:leuA,2,0,1,0,3,RV3710,P9WQB3,89.38027954101562
RVBD3404c:RVBD3404c,1,1,1,0,3,RV3404c,P9WKZ3,96.95756530761719
RVBD3867:espH,1,0,2,0,3,RV3867,O69732,76.44573974609375
RVBD2606c:snzP,3,0,0,0,3,RV2606c,P9WII9,94.73906707763672
RVBD1358:RVBD1358,1,2,0,0,3,RV1358,Q11028,79.74312591552734
RVBD3748:RVBD3748,3,0,0,0,3,RV3748,O69715,93.04388427734375
RVBD1070c:echA8,2,0,1,0,3,RV1070c,P9WNN9,98.02774810791016
RVBD2419c:gpgP,1,0,2,0,3,RV2419c,P9WIC7,95.68318176269531
RVBD3830c:RVBD3830c,1,0,1,1,3,RV3830c,P96248,88.63325500488281
RVBD0093c:RVBD0093c,1,1,1,0,3,RV0093c,P9WM69,75.59400939941406
RVBD1676:RVBD1676,1,1,1,0,3,RV1676,O53923,76.43397521972656
RVBD3153:nuoI,3,0,0,0,3,RV3153,P9WJG9,86.28966522216797
RVBD2221c:glnE,2,1,0,0,3,RV2221c,P9WN27,91.14799499511719
RVBD0873:fadE10,2,0,1,0,3,RV0873,P9WQF7,94.07600402832031
RVBD2148c:RVBD2148c,2,0,1,0,3,RV2148c,P9WFQ7,92.99752044677734
RVBD0059:RVBD0059,2,0,1,0,3,RV0059,O53604,96.27626037597656
RVBD3862c:whiB6,2,0,1,0,3,RV3862c,P9WF37,70.87491607666016
RVBD1194c:RVBD1194c,2,1,0,0,3,RV1194c,O05296,87.92394256591797
RVBD1206:fadD6,1,1,1,0,3,RV1206,O05307,90.69898986816406
RVBD2826c:RVBD2826c,0,3,0,0,3,RV2826c,P71626,94.2450942993164
RVBD3632:RVBD3632,2,0,1,0,3,RV3632,I6YGT7,63.77342224121094
RVBD3368c:RVBD3368c,2,1,0,0,3,RV3368c,O50397,96.5656967163086
RVBD0445c:sigK,2,1,0,0,3,RV0445c,P9WGH7,83.92523956298828
RVBD3070:RVBD3070,2,1,0,0,3,RV3070,P9WP61,96.55325317382812
RVBD2013:RVBD2013,1,1,1,0,3,RV2013,Q10844,84.93559265136719
RVBD0009:ppiA,1,1,1,0,3,RV0009,P9WHW3,94.61193084716797
RVBD3600c:RVBD3600c,1,0,2,0,3,RV3600c,P9WPA1,94.56702423095703
RVBD2661c:RVBD2661c,0,0,3,0,3,RV2661c,P71958,43.7718620300293
RVBD3126c:RVBD3126c,1,2,0,0,3,RV3126c,P9WL09,61.19615936279297
RVBD0938:ligD,2,0,1,0,3,RV0938,P9WNV3,89.69999694824219
RVBD1121:zwf1,2,0,1,0,3,RV1121,P9WN71,92.85482788085938
RVBD1690:lprJ,1,0,1,1,3,RV1690,O33192,72.77820587158203
RVBD0145:RVBD0145,2,0,1,0,3,RV0145,P9WFJ1,89.4699935913086
RVBD1079:metB,2,0,1,0,3,RV1079,P9WGB7,95.8984603881836
RVBD3756c:proZ,1,1,1,0,3,RV3756c,O69722,89.12736511230469
RVBD1677:dsbF,1,0,2,0,3,RV1677,I6XYM2,86.88428497314453
RVBD2964:purU,1,1,1,0,3,RV2964,P9WHM3,93.63455200195312
RVBD1131:prpC,2,0,0,1,3,RV1131,I6Y9Q3,94.03157806396484
RVBD3158:nuoN,3,0,0,0,3,RV3158,P9WIW9,92.79148864746094
RVBD2253:RVBD2253,0,1,2,0,3,RV2253,O53527,89.2414321899414
RVBD1627c:RVBD1627c,2,0,1,0,3,RV1627c,O06144,95.95877838134766
RVBD1351:RVBD1351,1,0,2,0,3,RV1351,P9WM17,48.77348327636719
RVBD0473:RVBD0473,0,1,2,0,3,RV0473,I6Y3V3,86.0298843383789
RVBD1441c:PE-PGRS26,2,0,1,0,3,RV1441c,Q79FP3,90.01557922363281
RVBD3495c:lprN,2,0,1,0,3,RV3495c,I6Y3P1,81.86853790283203
RVBD0943c:RVBD0943c,1,0,2,0,3,RV0943c,P9WKN7,69.98766326904297
RVBD2696c:RVBD2696c,2,0,1,0,3,RV2696c,I6XF31,81.60552215576172
RVBD0454:RVBD0454,2,1,0,0,3,RV0454,O86364,36.86896514892578
RVBD0776c:RVBD0776c,1,0,2,0,3,RV0776c,I6Y4S9,93.88926696777344
RVBD1431:RVBD1431,1,1,1,0,3,RV1431,O06827,93.96800994873047
RVBD1908c:katG,1,0,2,0,3,RV1908c,P9WIE5,96.06437683105469
RVBD1780:RVBD1780,0,1,2,0,3,RV1780,O53931,88.37347412109375
RVBD3273:RVBD3273,2,0,1,0,3,RV3273,P96878,85.52992248535156
RVBD3159c:PPE53,2,0,1,0,3,RV3159c,Q6MX04,93.13704681396484
RVBD0466:RVBD0466,2,0,1,0,3,RV0466,O53751,96.70476531982422
RVBD3390:lpqD,2,1,0,0,3,RV3390,O50416,91.55389404296875
RVBD1916:aceAb,2,1,0,0,3,RV1916,O07717,93.66645812988281
RVBD1620c:cydC,3,0,0,0,3,RV1620c,O06137,83.67994689941406
RVBD2871:vapB43,1,0,2,0,3,RV2871,P9WL41,85.99776458740234
RVBD3350c:PPE56,1,0,2,0,3,RV3350c,Q6MWX8,
RVBD2828c:RVBD2828c,2,1,0,0,3,RV2828c,I6X5G8,90.3939208984375
RVBD2502c:accD1,2,0,1,0,3,RV2502c,I6YDK7,96.67276000976562
RVBD2266:cyp124,1,0,2,0,3,RV2266,P9WPP3,92.48748016357422
RVBD3359:RVBD3359,2,1,0,0,3,RV3359,O50388,95.10913848876953
RVBD3716c:RVBD3716c,0,0,3,0,3,RV3716c,P9WNR9,85.10902404785156
RVBD1321:RVBD1321,1,0,2,0,3,RV1321,P9WIY5,91.7515869140625
RVBD1145:mmpL13a,2,0,1,0,3,RV1145,O06545,83.11038970947266
RVBD2185c:TB16.3,2,0,1,0,3,RV2185c,O53519,93.93618774414062
RVBD2669:RVBD2669,1,1,1,0,3,RV2669,P9WQG5,94.77762603759766
RVBD2170:RVBD2170,0,0,2,1,3,RV2170,O53504,93.11650848388672
RVBD2462c:tig,2,0,1,0,3,RV2462c,P9WG55,88.05583953857422
RVBD3741c:RVBD3741c,2,0,0,1,3,RV3741c,O69708,72.2208480834961
RVBD2851c:RVBD2851c,3,0,0,0,3,RV2851c,P9WFQ5,93.79269409179688
RVBD1161:narG,0,0,3,0,3,RV1161,P9WJQ3,95.70709228515625
RVBD2223c:RVBD2223c,2,0,1,0,3,RV2223c,P9WHR5,91.0296401977539
RVBD0029:RVBD0029,2,1,0,0,3,RV0029,P71599,80.8089599609375
RVBD2291:sseB,1,0,2,0,3,RV2291,P9WHF5,96.50736236572266
RVBD1373:RVBD1373,1,1,1,0,3,RV1373,P9WGB9,91.2413558959961
RVBD1066:RVBD1066,2,0,1,0,3,RV1066,O53414,96.11237335205078
RVBD0358:RVBD0358,2,0,1,0,3,RV0358,O06308,92.12995910644531
RVBD3358:relK,2,1,0,0,3,RV3358,P9WF09,97.24177551269531
RVBD1629:polA,2,0,0,1,3,RV1629,P9WNU5,89.29464721679688
RVBD2700:RVBD2700,3,0,0,0,3,RV2700,I6Y1I5,84.85990905761719
RVBD0171:mce1C,3,0,0,0,3,RV0171,O07415,74.89061737060547
RVBD1043c:RVBD1043c,3,0,0,0,3,RV1043c,P96358,85.26471710205078
RVBD2047c:RVBD2047c,2,0,0,0,2,RV2047c,P9WIH5,87.97703552246094
RVBD0309:RVBD0309,1,0,1,0,2,RV0309,O07236,92.81060028076172
RVBD3013:RVBD3013,2,0,0,0,2,RV3013,O53260,93.92816162109375
RVBD2938:drrC,2,0,0,0,2,RV2938,P9WG21,89.45742797851562
RVBD3868:eccA1,2,0,0,0,2,RV3868,P9WPH9,91.54935455322266
RVBD1998c:RVBD1998c,1,1,0,0,2,RV1998c,P9WLN9,96.97638702392578
RVBD2407:RVBD2407,2,0,0,0,2,RV2407,P9WGZ5,95.10458374023438
RVBD0774c:RVBD0774c,0,0,2,0,2,RV0774c,I6Y8R4,84.61821746826172
RVBD2566:RVBD2566,0,2,0,0,2,RV2566,Q50732,89.30880737304688
RVBD0157A:RVBD0157A,1,0,1,0,2,RV0157A,I6WXK8,73.56356811523438
RVBD2873A:RVBD2873A,1,0,1,0,2,RV2873A,,
RVBD3143:RVBD3143,2,0,0,0,2,RV3143,P9WGL7,89.42240142822266
RVBD3899c:RVBD3899c,1,0,1,0,2,RV3899c,O05446,74.22760772705078
RVBD1562c:treZ,1,0,1,0,2,RV1562c,P9WQ23,95.3869857788086
RVBD3019c:esxR,1,1,0,0,2,RV3019c,P9WNI9,90.5647964477539
RVBD0852:fadD16,1,1,0,0,2,RV0852,I6Y4Z4,68.80780792236328
RVBD0108c:RVBD0108c,0,2,0,0,2,RV0108c,O53630,93.38754272460938
RVBD2096c:pafB,1,0,1,0,2,RV2096c,P9WIM1,83.04479217529297
RVBD0317c:glpQ2,2,0,0,0,2,RV0317c,O07244,93.36070251464844
RVBD3701c:RVBD3701c,2,0,0,0,2,RV3701c,P9WN47,95.5792236328125
RVBD2340c:PE-PGRS39,1,0,1,0,2,RV2340c,L7N659,55.16086959838867
RVBD0477:RVBD0477,2,0,0,0,2,RV0477,P9WKV9,83.39702606201172
RVBD0112:gca,0,1,1,0,2,RV0112,O53634,95.74987030029297
RVBD3162c:RVBD3162c,0,1,1,0,2,RV3162c,O53312,57.052005767822266
RVBD0270:fadD2,0,1,1,0,2,RV0270,P95227,90.75003814697266
RVBD1068c:PE-PGRS20,1,0,1,0,2,RV1068c,P9WIF9,94.16666412353516
RVBD3835:RVBD3835,2,0,0,0,2,RV3835,P9WKW5,75.75772857666016
RVBD1953:vapC14,0,1,1,0,2,RV1953,P9WF99,82.15047454833984
RVBD3766:RVBD3766,0,1,1,0,2,RV3766,O69731,94.119384765625
RVBD1027c:kdpE,0,0,2,0,2,RV1027c,P9WGN1,89.46641540527344
RVBD0537c:RVBD0537c,2,0,0,0,2,RV0537c,O06403,81.81085968017578
RVBD0968:RVBD0968,2,0,0,0,2,RV0968,P9WKL9,77.06305694580078
RVBD3278c:RVBD3278c,2,0,0,0,2,RV3278c,P96883,61.06343078613281
RVBD2049c:RVBD2049c,2,0,0,0,2,RV2049c,O53491,89.03904724121094
RVBD0578c:PE-PGRS7,0,1,1,0,2,RV0578c,Q6MX28,71.26476287841797
RVBD2037c:RVBD2037c,2,0,0,0,2,RV2037c,L0TB61,83.97657775878906
RVBD2556c:RVBD2556c,2,0,0,0,2,RV2556c,P9WFP9,97.5501480102539
RVBD1259:udgB,1,0,1,0,2,RV1259,P9WM53,96.50798797607422
RVBD3484:cpsA,0,1,0,1,2,RV3484,O06347,80.58355712890625
RVBD0403c:mmpS1,2,0,0,0,2,RV0403c,P9WJT5,86.0755615234375
RVBD2324:RVBD2324,2,0,0,0,2,RV2324,P71888,94.51438903808594
RVBD0763c:RVBD0763c,0,0,2,0,2,RV0763c,P71820,88.27117156982422
RVBD1127c:ppdK,2,0,0,0,2,RV1127c,O06579,90.62311553955078
RVBD3728:RVBD3728,1,0,1,0,2,RV3728,O69695,79.24427795410156
RVBD0036c:RVBD0036c,2,0,0,0,2,RV0036c,P9WM91,96.1533432006836
RVBD3860:RVBD3860,0,1,1,0,2,RV3860,P96217,77.44831085205078
RVBD0676c:mmpL5,2,0,0,0,2,RV0676c,P9WJV1,83.46978759765625
RVBD2251:RVBD2251,0,0,2,0,2,RV2251,L0TBR2,88.15093994140625
RVBD1028A:kdpF,2,0,0,0,2,RV1028A,Q79FT7,96.86399841308594
RVBD1931c:RVBD1931c,1,0,1,0,2,RV1931c,P95283,54.045326232910156
RVBD2187:fadD15,1,0,1,0,2,RV2187,O53521,91.97276306152344
RVBD0213c:RVBD0213c,2,0,0,0,2,RV0213c,P96395,95.6497802734375
RVBD2902c:rnhB,1,0,0,1,2,RV2902c,P9WH01,81.5794677734375
RVBD3131:RVBD3131,0,0,2,0,2,RV3131,P9WIZ7,92.44694519042969
RVBD3284:RVBD3284,2,0,0,0,2,RV3284,P9WGC3,93.18560028076172
RVBD1044:RVBD1044,1,0,1,0,2,RV1044,P96357,91.01068115234375
RVBD3134c:RVBD3134c,1,0,1,0,2,RV3134c,P9WFD3,83.04242706298828
RVBD2030c:RVBD2030c,1,0,1,0,2,RV2030c,P9WLM1,86.03881072998047
RVBD1882c:RVBD1882c,2,0,0,0,2,RV1882c,O07749,93.23375701904297
RVBD0037c:RVBD0037c,2,0,0,0,2,RV0037c,P9WJY1,88.68656158447266
RVBD0304c:PPE5,2,0,0,0,2,RV0304c,Q6MX49,58.9369010925293
RVBD2300c:RVBD2300c,0,1,1,0,2,RV2300c,P9WLD7,87.15786743164062
RVBD1507c:RVBD1507c,2,0,0,0,2,RV1507c,P9WLW5,96.84351348876953
RVBD2744c:35kd-ag,2,0,0,0,2,RV2744c,P9WHP5,81.54467010498047
RVBD3197:RVBD3197,2,0,0,0,2,RV3197,Q6MX01,88.47315216064453
RVBD2658c:RVBD2658c,2,0,0,0,2,RV2658c,P9WL47,83.01615905761719
RVBD0888:RVBD0888,2,0,0,0,2,RV0888,P9WKQ1,78.4886703491211
RVBD1742:RVBD1742,1,0,1,0,2,RV1742,O33271,96.02611541748047
RVBD2950c:fadD29,2,0,0,0,2,RV2950c,P95141,87.30342864990234
RVBD0323c:RVBD0323c,0,0,2,0,2,RV0323c,L0T643,95.54296112060547
RVBD0267:narU,0,0,2,0,2,RV0267,P95224,92.53268432617188
RVBD3449:mycP4,1,0,1,0,2,RV3449,I6YC58,85.6834487915039
RVBD3796:RVBD3796,1,0,1,0,2,RV3796,P72062,88.9153823852539
RVBD3296:lhr,2,0,0,0,2,RV3296,P96901,83.19778442382812
RVBD3770c:RVBD3770c,2,0,0,0,2,RV3770c,P72037,91.73587036132812
RVBD1640c:lysX,2,0,0,0,2,RV1640c,P9WFU7,81.82241821289062
RVBD0154c:fadE2,2,0,0,0,2,RV0154c,P96831,96.74032592773438
RVBD0314c:RVBD0314c,2,0,0,0,2,RV0314c,O07241,72.51026916503906
RVBD3822:RVBD3822,1,0,1,0,2,RV3822,O07801,71.73443603515625
RVBD1569:bioF1,2,0,0,0,2,RV1569,P9WQ87,95.40482330322266
RVBD1894c:RVBD1894c,2,0,0,0,2,RV1894c,O07738,92.58553314208984
RVBD0895:RVBD0895,1,1,0,0,2,RV0895,P9WKA3,81.0528335571289
RVBD3078:hab,2,0,0,0,2,RV3078,I6Y2H3,97.23646545410156
RVBD2497c:bkdA,2,0,0,0,2,RV2497c,P9WIS3,95.059326171875
RVBD0835:lpqQ,2,0,0,0,2,RV0835,O53846,85.7159423828125
RVBD0600c:RVBD0600c,1,1,0,0,2,RV0600c,O07778,84.18922424316406
RVBD2177c:RVBD2177c,2,0,0,0,2,RV2177c,O53511,92.55824279785156
RVBD2468c:RVBD2468c,1,1,0,0,2,RV2468c,P9WLA7,87.12030029296875
RVBD2937:drrB,2,0,0,0,2,RV2937,P9WG23,79.38519287109375
RVBD1914c:RVBD1914c,1,0,1,0,2,RV1914c,O07719,91.26073455810547
RVBD3787c:RVBD3787c,1,0,1,0,2,RV3787c,P9WFH3,89.76350402832031
RVBD2712c:RVBD2712c,1,1,0,0,2,RV2712c,I6YE70,90.53016662597656
RVBD3866:espG1,2,0,0,0,2,RV3866,P96210,89.40538024902344
RVBD1714:RVBD1714,1,0,1,0,2,RV1714,P9WGQ3,94.07762908935547
RVBD1878:glnA3,0,0,2,0,2,RV1878,O07752,95.65715026855469
RVBD3826:fadD23,2,0,0,0,2,RV3826,P9WQ47,88.85729217529297
RVBD2585c:RVBD2585c,2,0,0,0,2,RV2585c,P9WL77,92.62330627441406
RVBD1181:pks4,1,0,1,0,2,RV1181,A0A089QRB9,86.92646789550781
RVBD3493c:RVBD3493c,1,0,1,0,2,RV3493c,I6X7G4,77.6443862915039
RVBD3660c:RVBD3660c,1,0,1,0,2,RV3660c,P9WKX7,88.01617431640625
RVBD0249c:RVBD0249c,1,0,1,0,2,RV0249c,O53671,90.39669799804688
RVBD0554:bpoC,2,0,0,0,2,RV0554,P9WNH1,96.77262878417969
RVBD1426c:lipO,2,0,0,0,2,RV1426c,O06832,92.23814392089844
RVBD0593:lprL,0,2,0,0,2,RV0593,I6Y461,81.25582122802734
RVBD2321c:rocD2,1,1,0,0,2,RV2321c,P71891,95.20364379882812
RVBD3776:RVBD3776,2,0,0,0,2,RV3776,P72042,84.38607025146484
RVBD2284:lipM,2,0,0,0,2,RV2284,Q50681,93.22607421875
RVBD1050:RVBD1050,1,1,0,0,2,RV1050,O53398,88.68425750732422
RVBD3595c:PE-PGRS59,1,0,1,0,2,RV3595c,Q6MWV6,88.86417388916016
RVBD1806:PE20,1,1,0,0,2,RV1806,L7N656,92.67597198486328
RVBD3316:sdhC,0,0,2,0,2,RV3316,O53368,89.6834716796875
RVBD2295:RVBD2295,0,1,1,0,2,RV2295,P9WFL7,93.23380279541016
RVBD2176:pknL,1,0,1,0,2,RV2176,P9WI63,81.32386016845703
RVBD1109c:RVBD1109c,2,0,0,0,2,RV1109c,P9WM59,71.29178619384766
RVBD1647:RVBD1647,0,1,1,0,2,RV1647,P94982,70.87208557128906
RVBD3015c:RVBD3015c,1,0,1,0,2,RV3015c,I6YAW3,96.37100982666016
RVBD0070c:glyA2,2,0,0,0,2,RV0070c,P9WGI7,97.60639953613281
RVBD1875:RVBD1875,1,0,1,0,2,RV1875,O07754,95.92632293701172
RVBD2563:RVBD2563,1,0,1,0,2,RV2563,P9WG15,90.62054443359375
RVBD3506:fadD17,2,0,0,0,2,RV3506,O53551,92.2713394165039
RVBD2415c:RVBD2415c,2,0,0,0,2,RV2415c,P71728,73.59959411621094
RVBD2956:RVBD2956,1,0,1,0,2,RV2956,I6Y242,91.67826843261719
RVBD0790c:RVBD0790c,1,0,1,0,2,RV0790c,I6XWA9,92.5707015991211
RVBD0963c:RVBD0963c,0,1,1,0,2,RV0963c,P9WKM7,92.04161834716797
RVBD1063c:RVBD1063c,1,0,1,0,2,RV1063c,P9WIY9,77.0030288696289
RVBD1218c:RVBD1218c,0,0,2,0,2,RV1218c,O86311,87.97452545166016
RVBD0487:RVBD0487,2,0,0,0,2,RV0487,P9WKU9,89.27841186523438
RVBD1407:fmu,1,0,1,0,2,RV1407,P9WGX3,94.86048889160156
RVBD0999:RVBD0999,2,0,0,0,2,RV0999,O05582,78.21110534667969
RVBD3311:RVBD3311,2,0,0,0,2,RV3311,O53362,88.42955017089844
RVBD0140:RVBD0140,1,1,0,0,2,RV0140,P96817,96.30770111083984
RVBD2077c:RVBD2077c,1,1,0,0,2,RV2077c,P9WLL1,62.04380416870117
RVBD1911c:lppC,2,0,0,0,2,RV1911c,P9WFN3,88.09098815917969
RVBD2386c:mbtI,2,0,0,0,2,RV2386c,P9WFX1,93.95186614990234
RVBD2118c:RVBD2118c,0,1,1,0,2,RV2118c,P9WFZ1,93.98081970214844
RVBD2306A:RVBD2306A,0,1,1,0,2,RV2306A,Q79FG5,55.94218063354492
RVBD0452:RVBD0452,1,0,1,0,2,RV0452,O53737,89.03224182128906
RVBD2778c:RVBD2778c,1,1,0,0,2,RV2778c,I6Y1P2,90.9969253540039
RVBD1246c:RVBD1246c,0,0,2,0,2,RV1246c,O50461,84.75257873535156
RVBD2620c:RVBD2620c,1,1,0,0,2,RV2620c,I6Y9U6,93.32567596435547
RVBD3648c:cspA,1,0,1,0,2,RV3648c,P9WP75,94.26313018798828
RVBD3666B:RVBD3666B,1,1,0,0,2,RV3666B,,
RVBD2092c:helY,0,0,2,0,2,RV2092c,P9WMR1,86.64437103271484
RVBD0397A:RVBD0397A,2,0,0,0,2,RV0397A,I6Y3N9,71.41536712646484
RVBD0920c:RVBD0920c,0,0,1,1,2,RV0920c,I6Y941,82.78385162353516
RVBD1281c:oppD,2,0,0,0,2,RV1281c,P9WQJ5,91.46217346191406
RVBD2805:RVBD2805,2,0,0,0,2,RV2805,P71646,74.88410949707031
RVBD1520:RVBD1520,1,0,1,0,2,RV1520,P9WLV5,89.95207214355469
RVBD3683:RVBD3683,1,0,1,0,2,RV3683,I6X827,90.5877456665039
RVBD3421c:RVBD3421c,0,0,2,0,2,RV3421c,P9WKY7,93.29768371582031
RVBD0942:RVBD0942,0,1,1,0,2,RV0942,P9WKN9,53.71923828125
RVBD0343:iniC,2,0,0,0,2,RV0343,P9WJ95,88.3084716796875
RVBD3852:hns,1,0,1,0,2,RV3852,I6YHB0,63.86022186279297
RVBD1501:RVBD1501,0,1,1,0,2,RV1501,P9WI91,93.48776245117188
RVBD0247c:RVBD0247c,1,0,1,0,2,RV0247c,O53669,95.06999969482422
RVBD3111:moaC1,2,0,0,0,2,RV3111,P9WJR9,91.19070434570312
RVBD2693c:RVBD2693c,2,0,0,0,2,RV2693c,I6X548,64.27336883544922
RVBD3620c:esxW,2,0,0,0,2,RV3620c,P9WNI3,87.54460144042969
RVBD0536:galE3,1,0,1,0,2,RV0536,L7N670,94.6495132446289
RVBD3201c:RVBD3201c,2,0,0,0,2,RV3201c,O53347,84.1602783203125
RVBD1216c:RVBD1216c,2,0,0,0,2,RV1216c,O05317,95.04853057861328
RVBD2004c:RVBD2004c,2,0,0,0,2,RV2004c,P9WLN3,91.03324890136719
RVBD3211:rhlE,2,0,0,0,2,RV3211,O05855,79.65423583984375
RVBD1478:RVBD1478,2,0,0,0,2,RV1478,P9WHU5,85.03494262695312
RVBD1801:PPE29,2,0,0,0,2,RV1801,P9WI09,67.28888702392578
RVBD0114:gmhB,1,0,1,0,2,RV0114,P9WMV3,93.31962585449219
RVBD3886c:mycP2,2,0,0,0,2,RV3886c,O05458,85.57891082763672
RVBD3842c:glpQ1,0,1,0,1,2,RV3842c,P9WMU3,93.65087890625
RVBD3172c:RVBD3172c,0,1,1,0,2,RV3172c,O53322,57.45918655395508
RVBD0688:RVBD0688,1,0,1,0,2,RV0688,P95034,94.4614028930664
RVBD0519c:RVBD0519c,2,0,0,0,2,RV0519c,O33364,85.6112060546875
RVBD2782c:pepR,0,0,2,0,2,RV2782c,P9WHT5,94.42815399169922
RVBD0485:RVBD0485,1,0,1,0,2,RV0485,P9WKV1,87.49373626708984
RVBD2852c:mqo,2,0,0,0,2,RV2852c,P9WJP5,93.18193054199219
RVBD3130c:tgs1,0,0,2,0,2,RV3130c,P9WKC9,79.60552978515625
RVBD3691:RVBD3691,2,0,0,0,2,RV3691,O69659,87.57060241699219
RVBD0580c:RVBD0580c,2,0,0,0,2,RV0580c,O53777,85.6790771484375
RVBD1719:RVBD1719,2,0,0,0,2,RV1719,P71977,92.47161865234375
RVBD1834:lipZ,2,0,0,0,2,RV1834,P9WLR1,94.72048950195312
RVBD1732c:RVBD1732c,0,1,1,0,2,RV1732c,P71990,97.81600189208984
RVBD0862c:RVBD0862c,1,0,1,0,2,RV0862c,O53874,89.57279205322266
RVBD1289:RVBD1289,1,1,0,0,2,RV1289,P9WM37,91.28990173339844
RVBD3097c:lipY,2,0,0,0,2,RV3097c,I6Y2J4,80.83478546142578
RVBD6039:tRNA-Ala37,0,1,1,0,2,RV6039,,
RVBD1937:RVBD1937,0,1,1,0,2,RV1937,P95277,87.41515350341797
RVBD3785:RVBD3785,2,0,0,0,2,RV3785,P9WKX1,89.18997192382812
RVBD3136A:RVBD3136A,2,0,0,0,2,RV3136A,I6Y2Q7,87.8404541015625
RVBD1731:gabD2,2,0,0,0,2,RV1731,P9WNX7,96.45588684082031
RVBD3441c:mrsA,1,0,0,1,2,RV3441c,P9WN41,94.7103271484375
RVBD3522:ltp4,2,0,0,0,2,RV3522,O53567,95.59202575683594
RVBD0346c:ansP2,1,0,1,0,2,RV0346c,P9WQM7,88.51963806152344
RVBD3386:RVBD3386,1,0,1,0,2,RV3386,O50413,79.3830795288086
RVBD2503c:scoB,1,1,0,0,2,RV2503c,P9WPW3,95.10152435302734
RVBD0744c:RVBD0744c,0,0,2,0,2,RV0744c,O53807,89.45148468017578
RVBD0885:RVBD0885,2,0,0,0,2,RV0885,P9WKQ5,90.74073791503906
RVBD2496c:bkdB,2,0,0,0,2,RV2496c,P9WIS1,93.84584045410156
RVBD1207:folP2,1,0,1,0,2,RV1207,P9WNC9,89.96774291992188
RVBD1226c:RVBD1226c,2,0,0,0,2,RV1226c,O33222,82.87286376953125
RVBD0098:fcoT,2,0,0,0,2,RV0098,P9WM67,90.92202758789062
RVBD1687c:RVBD1687c,1,0,1,0,2,RV1687c,O33189,89.11791229248047
RVBD2311:RVBD2311,2,0,0,0,2,RV2311,P9WLC1,65.8253402709961
RVBD3543c:fadE29,2,0,0,0,2,RV3543c,P71858,94.63077545166016
RVBD3901c:RVBD3901c,2,0,0,0,2,RV3901c,O05444,60.852481842041016
RVBD2774c:RVBD2774c,1,1,0,0,2,RV2774c,O33316,34.375526428222656
RVBD2924c:fpg,2,0,0,0,2,RV2924c,P9WNC3,90.40453338623047
RVBD1331:RVBD1331,1,1,0,0,2,RV1331,P9WPC1,85.06575012207031
RVBD3150:nuoF,2,0,0,0,2,RV3150,P9WIV7,94.58330535888672
RVBD3146:nuoB,2,0,0,0,2,RV3146,P9WJH1,86.50798797607422
RVBD2708c:RVBD2708c,1,0,1,0,2,RV2708c,I6X562,65.98682403564453
RVBD3155:nuoK,1,0,1,0,2,RV3155,P9WIX3,92.09505462646484
RVBD2935:ppsE,2,0,0,0,2,RV2935,P9WQE1,86.75340270996094
RVBD0091:mtn,1,0,1,0,2,RV0091,P9WJM3,94.89471435546875
RVBD3832c:RVBD3832c,0,1,1,0,2,RV3832c,P96246,92.78990173339844
RVBD2254c:RVBD2254c,0,1,1,0,2,RV2254c,O53528,85.15847778320312
RVBD1106c:RVBD1106c,2,0,0,0,2,RV1106c,P9WQP7,92.20289611816406
RVBD0935:pstC1,1,1,0,0,2,RV0935,P9WG07,88.27938079833984
RVBD0476:RVBD0476,2,0,0,0,2,RV0476,P9WKW1,96.50757598876953
RVBD2876:RVBD2876,1,0,1,0,2,RV2876,P9WL39,73.84587097167969
RVBD1751:RVBD1751,0,0,2,0,2,RV1751,O65936,84.27247619628906
RVBD1042c:RVBD1042c,2,0,0,0,2,RV1042c,L0T897,77.63734436035156
RVBD1723:RVBD1723,1,0,1,0,2,RV1723,P71981,92.1902847290039
RVBD1205:RVBD1205,0,1,1,0,2,RV1205,O05306,94.90984344482422
RVBD1487:RVBD1487,2,0,0,0,2,RV1487,P71767,72.19771575927734
RVBD3487c:lipF,1,0,1,0,2,RV3487c,O06350,89.62942504882812
RVBD1550:fadD11,2,0,0,0,2,RV1550,P9WQ53,80.28849792480469
RVBD0104:RVBD0104,1,0,1,0,2,RV0104,P9WM61,82.88605499267578
RVBD3881c:espB,2,0,0,0,2,RV3881c,P9WJD9,70.1579360961914
RVBD0074:RVBD0074,2,0,0,0,2,RV0074,O53619,93.14012908935547
RVBD3212:RVBD3212,2,0,0,0,2,RV3212,O05854,95.35155487060547
RVBD0655:mkl,1,0,1,0,2,RV0655,P9WQL5,86.29891204833984
RVBD3045:adhC,2,0,0,0,2,RV3045,P9WQC5,96.98432922363281
RVBD3259:RVBD3259,1,1,0,0,2,RV3259,O53352,88.42395782470703
RVBD3290c:lat,2,0,0,0,2,RV3290c,P9WQ77,96.286865234375
RVBD3147:nuoC,2,0,0,0,2,RV3147,P9WJH3,84.9698257446289
RVBD0782:ptrBb,1,1,0,0,2,RV0782,P71834,90.9894790649414
RVBD3208A:TB9.4,2,0,0,0,2,RV3208A,Q6MWZ8,84.82189178466797
RVBD2694c:RVBD2694c,2,0,0,0,2,RV2694c,O07196,85.35484313964844
RVBD0456c:echA2,1,0,0,1,2,RV0456c,O07179,95.26092529296875
RVBD3815c:RVBD3815c,2,0,0,0,2,RV3815c,O07808,89.71063232421875
RVBD3170:aofH,2,0,0,0,2,RV3170,P9WQ15,94.2739028930664
RVBD2663:RVBD2663,1,0,1,0,2,RV2663,I6X520,97.25467681884766
RVBD0172:mce1D,1,0,1,0,2,RV0172,O07416,78.38573455810547
RVBD1071c:echA9,2,0,0,0,2,RV1071c,O53419,97.41603088378906
RVBD2379c:mbtF,1,0,1,0,2,RV2379c,O05819,86.0740966796875
RVBD0491:regX3,1,0,1,0,2,RV0491,P9WGL9,90.54122924804688
RVBD0428c:RVBD0428c,2,0,0,0,2,RV0428c,P96274,90.90599060058594
RVBD3420c:rimI,0,1,1,0,2,RV3420c,I6YG32,93.58607482910156
RVBD2910c:RVBD2910c,1,0,1,0,2,RV2910c,P9WL25,94.93768310546875
RVBD1095:phoH2,2,0,0,0,2,RV1095,O53443,86.90744018554688
RVBD3732:RVBD3732,2,0,0,0,2,RV3732,O69699,75.51469421386719
RVBD2630:RVBD2630,2,0,0,0,2,RV2630,P9WQ03,83.5265884399414
RVBD2900c:fdhF,2,0,0,0,2,RV2900c,P9WJP9,94.39999389648438
RVBD0917:betP,1,0,1,0,2,RV0917,P9WPR7,85.01860046386719
RVBD1573:RVBD1573,0,0,2,0,2,RV1573,O06617,62.206398010253906
RVBD2346c:esxO,2,0,0,0,2,RV2346c,P9WNI7,94.35478973388672
RVBD1809:PPE33,1,0,1,0,2,RV1809,P9WI03,72.03540802001953
RVBD0983:pepD,2,0,0,0,2,RV0983,O53896,74.69027709960938
RVBD3480c:RVBD3480c,1,0,1,0,2,RV3480c,P9WKA7,84.01963806152344
RVBD3286c:sigF,1,0,1,0,2,RV3286c,P9WGI3,86.63601684570312
RVBD1002c:RVBD1002c,2,0,0,0,2,RV1002c,P9WN05,91.9773178100586
RVBD2464c:RVBD2464c,1,0,1,0,2,RV2464c,P9WNB9,96.34220123291016
RVBD1876:bfrA,1,0,1,0,2,RV1876,P9WPQ9,98.425537109375
RVBD0237:lpqI,2,0,0,0,2,RV0237,L7N6B0,91.95076751708984
RVBD1143:mcr,2,0,0,0,2,RV1143,O06543,95.78752136230469
RVBD0360c:RVBD0360c,0,1,1,0,2,RV0360c,O06310,92.61688995361328
RVBD2668:RVBD2668,1,1,0,0,2,RV2668,P71965,88.45514678955078
RVBD1696:recN,1,0,1,0,2,RV1696,P9WHI7,88.3664321899414
RVBD1672c:RVBD1672c,1,0,1,0,2,RV1672c,O53919,85.9200439453125
RVBD2863:vapC23,1,0,1,0,2,RV2863,P9WF89,97.03231048583984
RVBD1164:narI,1,0,1,0,2,RV1164,O06562,91.35796356201172
RVBD1345:mbtM,0,1,1,0,2,RV1345,P9WQ41,88.54170227050781
RVBD3541c:RVBD3541c,2,0,0,0,2,RV3541c,I6XHI0,97.45930480957031
RVBD0195:RVBD0195,1,1,0,0,2,RV0195,O53646,82.02018737792969
RVBD2309A:RVBD2309A,0,2,0,0,2,RV2309A,L7N666,46.14632034301758
RVBD0387c:RVBD0387c,2,0,0,0,2,RV0387c,L0T6I4,48.739715576171875
RVBD3330:dacB1,2,0,0,0,2,RV3330,O53380,89.3523941040039
RVBD0402c:mmpL1,1,0,0,1,2,RV0402c,P9WJV9,84.98982238769531
RVBD2914c:pknI,2,0,0,0,2,RV2914c,P9WI69,74.49900817871094
RVBD2801A:mazE9,1,0,1,0,2,RV2801A,P0CL61,94.67762756347656
RVBD2525c:RVBD2525c,2,0,0,0,2,RV2525c,I6XEI5,91.36520385742188
RVBD2403c:lppR,1,0,1,0,2,RV2403c,P71740,89.05960845947266
RVBD2706c:RVBD2706c,1,0,1,0,2,RV2706c,O07207,42.328704833984375
RVBD1350:fabG2,2,0,0,0,2,RV1350,P9WGR9,97.00235748291016
RVBD0500B:RVBD0500B,0,0,2,0,2,RV0500B,P9WKT5,91.4866714477539
RVBD2137c:RVBD2137c,1,0,1,0,2,RV2137c,O06238,71.9212417602539
RVBD0677c:mmpS5,2,0,0,0,2,RV0677c,P9WJS7,89.68386840820312
RVBD2236c:cobD,1,0,1,0,2,RV2236c,P9WP93,94.57999420166016
RVBD0970:RVBD0970,1,0,1,0,2,RV0970,P9WKL7,69.90343475341797
RVBD0996:RVBD0996,2,0,0,0,2,RV0996,O05579,62.62952423095703
RVBD1228:lpqX,1,1,0,0,2,RV1228,O33224,62.7617301940918
RVBD1808:PPE32,2,0,0,0,2,RV1808,P9WI05,70.5979995727539
RVBD1290c:RVBD1290c,2,0,0,0,2,RV1290c,P9WM35,80.15863800048828
RVBD1048c:RVBD1048c,1,1,0,0,2,RV1048c,P96353,84.2695083618164
RVBD2231Ac:RVBD2231Ac,2,0,0,0,2,RV2231Ac,,
RVBD3631:RVBD3631,1,0,1,0,2,RV3631,O06376,80.00248718261719
RVBD2957:RVBD2957,2,0,0,0,2,RV2957,P9WMX7,86.72035217285156
RVBD1085c:RVBD1085c,1,0,0,1,2,RV1085c,P9WFN7,92.01223754882812
RVBD1917c:PPE34,2,0,0,0,2,RV1917c,Q79FI9,67.16744995117188
RVBD2162c:PE-PGRS38,2,0,0,0,2,RV2162c,L7N6A1,94.19367980957031
RVBD2819c:RVBD2819c,1,0,1,0,2,RV2819c,P9WJF5,88.00045013427734
RVBD2409c:RVBD2409c,1,1,0,0,2,RV2409c,P71734,95.49494934082031
RVBD1064c:lpqV,1,0,1,0,2,RV1064c,P9WK57,81.1256103515625
RVBD3760:RVBD3760,1,1,0,0,2,RV3760,O69726,81.77291870117188
RVBD2032:acg,0,1,1,0,2,RV2032,P9WIZ9,93.42915344238281
RVBD1625c:cya,1,0,1,0,2,RV1625c,P9WQ35,86.9482421875
RVBD0313:RVBD0313,2,0,0,0,2,RV0313,P9WL03,67.33226013183594
RVBD0944:RVBD0944,0,0,1,1,2,RV0944,L0T864,88.67411041259766
RVBD2435c:RVBD2435c,2,0,0,0,2,RV2435c,P71914,88.24049377441406
RVBD2334:cysK1,2,0,0,0,2,RV2334,P9WP55,97.05281066894531
RVBD2857c:RVBD2857c,2,0,0,0,2,RV2857c,I6Y1W3,97.19697570800781
RVBD1518:RVBD1518,1,1,0,0,2,RV1518,P9WLV9,89.2555160522461
RVBD1938:ephB,1,1,0,0,2,RV1938,I6YC03,97.24946594238281
RVBD2579:dhaA,0,1,1,0,2,RV2579,P9WMR9,97.1542739868164
RVBD0265c:RVBD0265c,2,0,0,0,2,RV0265c,L7N6B2,92.58378601074219
RVBD2101:helZ,0,1,1,0,2,RV2101,I6YCF3,83.06108856201172
RVBD0040c:mtc28,2,0,0,0,2,RV0040c,P9WIM9,75.1760025024414
RVBD3828c:RVBD3828c,2,0,0,0,2,RV3828c,O07795,82.58965301513672
RVBD0130:htdZ,0,0,2,0,2,RV0130,P9WNP3,97.88145446777344
RVBD3569c:hsaD,2,0,0,0,2,RV3569c,P9WNH5,97.02759552001953
RVBD3435c:RVBD3435c,1,1,0,0,2,RV3435c,O06252,78.33917999267578
RVBD0634A:RVBD0634A,2,0,0,0,2,RV0634A,P9WKS5,70.99156951904297
RVBD2141c:RVBD2141c,1,0,1,0,2,RV2141c,L7N684,94.50678253173828
RVBD3447c:eccC4,1,0,1,0,2,RV3447c,P9WNA7,84.85671997070312
RVBD1774:RVBD1774,1,0,1,0,2,RV1774,O33177,97.02576446533203
RVBD1482c:RVBD1482c,1,1,0,0,2,RV1482c,P71763,93.83074951171875
RVBD1332:RVBD1332,0,0,2,0,2,RV1332,P9WM25,85.17913055419922
RVBD1678:RVBD1678,2,0,0,0,2,RV1678,O53925,89.17766571044922
RVBD2074:RVBD2074,2,0,0,0,2,RV2074,P9WLL7,93.39423370361328
RVBD1457c:RVBD1457c,1,0,1,0,2,RV1457c,O86349,88.68984985351562
RVBD2790c:ltp1,1,0,1,0,2,RV2790c,O33332,96.64653015136719
RVBD0946c:pgi,0,1,1,0,2,RV0946c,P9WN69,97.78845977783203
RVBD3718c:RVBD3718c,2,0,0,0,2,RV3718c,I6XI16,89.57463073730469
RVBD3784:RVBD3784,2,0,0,0,2,RV3784,P72050,92.0775146484375
RVBD0191:RVBD0191,1,0,1,0,2,RV0191,P9WJX7,88.41300964355469
RVBD0837c:RVBD0837c,1,1,0,0,2,RV0837c,I6Y4Y1,87.05467987060547
RVBD1841c:RVBD1841c,2,0,0,0,2,RV1841c,P9WLQ7,87.8191909790039
RVBD2451:RVBD2451,1,1,0,0,2,RV2451,O53178,35.22969436645508
RVBD3877:eccD1,2,0,0,0,2,RV3877,P9WNQ7,85.43772888183594
RVBD2562:RVBD2562,0,1,1,0,2,RV2562,P9WL99,82.68939208984375
RVBD0094c:RVBD0094c,2,0,0,0,2,RV0094c,Q50655,85.34475708007812
RVBD2140c:TB18.6,1,0,1,0,2,RV2140c,P9WFN1,96.87999725341797
RVBD3373:echA18,0,0,2,0,2,RV3373,O50402,92.44808197021484
RVBD3008:RVBD3008,2,0,0,0,2,RV3008,I6YEY1,60.94888687133789
RVBD1022:lpqU,2,0,0,0,2,RV1022,P96378,90.05194091796875
RVBD3096:RVBD3096,0,1,1,0,2,RV3096,I6YB54,93.28350830078125
RVBD0271c:fadE6,0,1,1,0,2,RV0271c,P95228,93.56077575683594
RVBD0900:RVBD0900,1,0,1,0,2,RV0900,P9WJG7,80.4188003540039
RVBD2683:RVBD2683,2,0,0,0,2,RV2683,I6X540,87.05375671386719
RVBD3300c:RVBD3300c,1,1,0,0,2,RV3300c,O07166,88.6102294921875
RVBD2564:glnQ,1,0,1,0,2,RV2564,P9WQI5,88.94230651855469
RVBD0456B:RVBD0456B,1,0,1,0,2,RV0456B,P0CL57,69.84578704833984
RVBD1653:argJ,1,0,0,1,2,RV1653,P9WPZ3,95.55642700195312
RVBD3555c:RVBD3555c,1,0,1,0,2,RV3555c,P96837,93.86674499511719
RVBD2689c:RVBD2689c,2,0,0,0,2,RV2689c,O07191,95.4735336303711
RVBD3272:RVBD3272,2,0,0,0,2,RV3272,P96877,93.55233001708984
RVBD3849:espR,0,2,0,0,2,RV3849,P9WJB7,93.50121307373047
RVBD0990c:RVBD0990c,2,0,0,0,2,RV0990c,O05573,83.62349700927734
RVBD0393:RVBD0393,2,0,0,0,2,RV0393,P95201,73.81097412109375
RVBD3740c:RVBD3740c,2,0,0,0,2,RV3740c,P9WKA5,86.06153869628906
RVBD1261c:RVBD1261c,0,0,2,0,2,RV1261c,P9WP13,94.76436614990234
RVBD1534:RVBD1534,1,0,0,0,1,RV1534,O08377,86.60231018066406
RVBD0277c:vapC25,0,0,1,0,1,RV0277c,P9WF85,96.83429718017578
RVBD1053c:RVBD1053c,1,0,0,0,1,RV1053c,O53401,54.397911071777344
RVBD1920:RVBD1920,0,0,1,0,1,RV1920,O53962,89.44024658203125
RVBD1788:PE18,0,1,0,0,1,RV1788,L7N649,96.57717895507812
RVBD0919:RVBD0919,1,0,0,0,1,RV0919,I6XA42,96.14403533935547
RVBD0199:RVBD0199,1,0,0,0,1,RV0199,O53650,78.19483947753906
RVBD3332:nagA,1,0,0,0,1,RV3332,O53382,96.48676300048828
RVBD2813:RVBD2813,1,0,0,0,1,RV2813,I6XFD1,94.37566375732422
RVBD1557:mmpL6,0,0,1,0,1,RV1557,P9WJU9,78.1565933227539
RVBD0061c:RVBD0061c,1,0,0,0,1,RV0061c,I6X8E6,84.06089782714844
RVBD0203:RVBD0203,1,0,0,0,1,RV0203,I6X8R5,77.99662780761719
RVBD0339c:RVBD0339c,1,0,0,0,1,RV0339c,O33269,87.47261810302734
RVBD0421c:RVBD0421c,0,0,1,0,1,RV0421c,P96267,96.52057647705078
RVBD0974c:accD2,1,0,0,0,1,RV0974c,O86318,97.1885757446289
RVBD1589:bioB,1,0,0,0,1,RV1589,P9WPQ7,93.08492279052734
RVBD0475:hbhA,1,0,0,0,1,RV0475,P9WIP9,68.72834014892578
RVBD1320c:RVBD1320c,1,0,0,0,1,RV1320c,P9WQ29,83.04895782470703
RVBD1993c:RVBD1993c,1,0,0,0,1,RV1993c,P9WLP5,88.53289031982422
RVBD3310:sapM,1,0,0,0,1,RV3310,O53361,91.03916931152344
RVBD2161c:RVBD2161c,1,0,0,0,1,RV2161c,O06216,94.50257110595703
RVBD0325:RVBD0325,0,0,1,0,1,RV0325,O07250,89.20919036865234
RVBD0880:RVBD0880,1,0,0,0,1,RV0880,P9WMF1,93.84839630126953
RVBD3725:RVBD3725,0,1,0,0,1,RV3725,O69692,78.1353759765625
RVBD1965:yrbE3B,1,0,0,0,1,RV1965,O53966,88.3681869506836
RVBD0139:RVBD0139,1,0,0,0,1,RV0139,P96816,92.37538146972656
RVBD1954c:RVBD1954c,1,0,0,0,1,RV1954c,P9WLQ3,29.492198944091797
RVBD0848:cysK2,1,0,0,0,1,RV0848,Q79FV4,92.70855712890625
RVBD1843c:guaB1,0,1,0,0,1,RV1843c,P9WKI3,93.89644622802734
RVBD3020c:esxS,1,0,0,0,1,RV3020c,Q6MX18,84.77288055419922
RVBD1759c:wag22,1,0,0,0,1,RV1759c,P9WIG5,90.75907897949219
RVBD0615:RVBD0615,1,0,0,0,1,RV0615,O07762,74.93937683105469
RVBD2601:speE,0,0,1,0,1,RV2601,P9WGE5,89.11629486083984
RVBD0816c:thiX,1,0,0,0,1,RV0816c,I6Y8V2,85.7760009765625
RVBD1443c:RVBD1443c,0,0,1,0,1,RV1443c,O06816,94.01006317138672
RVBD1217c:RVBD1217c,1,0,0,0,1,RV1217c,O05318,89.54454803466797
RVBD3912:RVBD3912,1,0,0,0,1,RV3912,P9WJ65,78.64180755615234
RVBD0038:RVBD0038,1,0,0,0,1,RV0038,P9WFK5,91.25999450683594
RVBD1324:RVBD1324,1,0,0,0,1,RV1324,P9WG61,85.60930633544922
RVBD0789c:RVBD0789c,1,0,0,0,1,RV0789c,I6Y4U0,79.96894836425781
RVBD3192:RVBD3192,1,0,0,0,1,RV3192,O53338,85.1270523071289
RVBD1958c:RVBD1958c,1,0,0,0,1,RV1958c,P95256,32.71107864379883
RVBD1681:moeX,1,0,0,0,1,RV1681,O33183,89.5522689819336
RVBD0882:RVBD0882,1,0,0,0,1,RV0882,P9WKQ9,66.60201263427734
RVBD3749c:RVBD3749c,0,1,0,0,1,RV3749c,L0TGF0,76.33130645751953
RVBD3478:PPE60,1,0,0,0,1,RV3478,Q6MWX1,68.14585876464844
RVBD0775:RVBD0775,1,0,0,0,1,RV0775,P71830,93.15879821777344
RVBD2913c:RVBD2913c,1,0,0,0,1,RV2913c,P9WJH9,92.04354095458984
RVBD1393c:RVBD1393c,1,0,0,0,1,RV1393c,P71662,95.42681121826172
RVBD0662c:vapB7,0,0,1,0,1,RV0662c,O06777,89.9941635131836
RVBD3249c:RVBD3249c,1,0,0,0,1,RV3249c,O05892,92.27251434326172
RVBD1279:RVBD1279,0,1,0,0,1,RV1279,P9WMV5,96.40694427490234
RVBD0573c:pncB2,0,0,1,0,1,RV0573c,P9WJI7,93.7250747680664
RVBD1874:RVBD1874,1,0,0,0,1,RV1874,O07755,96.53333282470703
RVBD0533c:fabH,0,0,1,0,1,RV0533c,P9WNG3,97.99666595458984
RVBD2171:lppM,0,0,0,1,1,RV2171,O53505,83.20140075683594
RVBD1977:RVBD1977,1,0,0,0,1,RV1977,O53978,82.10419464111328
RVBD0991c:RVBD0991c,1,0,0,0,1,RV0991c,O05574,71.27835845947266
RVBD0887c:RVBD0887c,0,1,0,0,1,RV0887c,P9WKQ3,90.22605895996094
RVBD3788:RVBD3788,1,0,0,0,1,RV3788,P9WKW7,80.75472259521484
RVBD0828c:RVBD0828c,1,0,0,0,1,RV0828c,O53839,85.2103500366211
RVBD0441c:RVBD0441c,1,0,0,0,1,RV0441c,P9WKW3,92.83929443359375
RVBD0030:RVBD0030,1,0,0,0,1,RV0030,P9WM95,84.4815444946289
RVBD1486c:RVBD1486c,1,0,0,0,1,RV1486c,P9WLX3,87.42003631591797
RVBD1021:RVBD1021,1,0,0,0,1,RV1021,P96379,89.56086730957031
RVBD1735Ac:RVBD1735Ac,1,0,0,0,1,RV1735Ac,,
RVBD3357:relJ,1,0,0,0,1,RV3357,P9WF25,93.58736419677734
RVBD2821c:RVBD2821c,1,0,0,0,1,RV2821c,P9WJF9,90.50215911865234
RVBD2915c:RVBD2915c,1,0,0,0,1,RV2915c,P9WL23,95.77236938476562
RVBD2258c:RVBD2258c,1,0,0,0,1,RV2258c,O53532,97.11878204345703
RVBD2255c:RVBD2255c,1,0,0,0,1,RV2255c,O53529,65.59405517578125
RVBD3000:RVBD3000,1,0,0,0,1,RV3000,I6X5Z8,87.92913818359375
RVBD2084:RVBD2084,1,0,0,0,1,RV2084,P9WLK1,70.25629425048828
RVBD3856c:RVBD3856c,1,0,0,0,1,RV3856c,P96221,97.40393829345703
RVBD2522c:RVBD2522c,1,0,0,0,1,RV2522c,I6X4J0,93.20589447021484
RVBD2086:RVBD2086,1,0,0,0,1,RV2086,P64937,69.74860382080078
RVBD2640c:RVBD2640c,1,0,0,0,1,RV2640c,I6Y1A7,92.14923095703125
RVBD3705c:RVBD3705c,1,0,0,0,1,RV3705c,I6XI06,88.33073425292969
RVBD1887:RVBD1887,1,0,0,0,1,RV1887,O07745,74.23460388183594
RVBD3149:nuoE,1,0,0,0,1,RV3149,P9WIV5,92.53237915039062
RVBD2797c:RVBD2797c,1,0,0,0,1,RV2797c,P71654,86.40320587158203
RVBD1176c:RVBD1176c,1,0,0,0,1,RV1176c,O50432,90.87147521972656
RVBD1088:PE9,1,0,0,0,1,RV1088,Q79FS8,74.22110748291016
RVBD3689:RVBD3689,0,0,1,0,1,RV3689,I6YCR8,72.31381225585938
RVBD0272c:RVBD0272c,1,0,0,0,1,RV0272c,P95229,96.50868225097656
RVBD0886:fprB,1,0,0,0,1,RV0886,P9WJI1,92.55332946777344
RVBD0138:RVBD0138,1,0,0,0,1,RV0138,P96815,96.2899398803711
RVBD1342c:RVBD1342c,0,0,1,0,1,RV1342c,P9WM19,90.75592803955078
RVBD1209:RVBD1209,1,0,0,0,1,RV1209,O05310,82.82467651367188
RVBD2760c:vapB42,1,0,0,0,1,RV2760c,P9WJ19,93.2369613647461
RVBD0263c:RVBD0263c,0,0,0,1,1,RV0263c,P95220,95.66352844238281
RVBD1399c:nlhH,1,0,0,0,1,RV1399c,P9WK87,95.76062774658203
RVBD0755A:RVBD0755A,0,1,0,0,1,RV0755A,Q79FW3,90.43802642822266
RVBD1674c:RVBD1674c,1,0,0,0,1,RV1674c,O53921,95.41169738769531
RVBD2590:fadD9,1,0,0,0,1,RV2590,Q50631,87.37757110595703
RVBD2558:RVBD2558,1,0,0,0,1,RV2558,P9WLA3,88.40995788574219
RVBD2142A:parD2,0,1,0,0,1,RV2142A,P9WJ75,60.58450698852539
RVBD1148c:RVBD1148c,1,0,0,0,1,RV1148c,P9WM55,89.48751068115234
RVBD1428c:RVBD1428c,1,0,0,0,1,RV1428c,O06830,90.7257080078125
RVBD3375:amiD,1,0,0,0,1,RV3375,P9WQ93,96.45746612548828
RVBD3590c:PE-PGRS58,1,0,0,0,1,RV3590c,I6XHM5,85.69652557373047
RVBD2002:fabG3,0,0,0,1,1,RV2002,P9WGT1,97.25877380371094
RVBD0545c:pitA,1,0,0,0,1,RV0545c,P9WIA7,89.49842834472656
RVBD3177:RVBD3177,1,0,0,0,1,RV3177,O53327,92.79653930664062
RVBD2370c:RVBD2370c,1,0,0,0,1,RV2370c,O05828,85.94316864013672
RVBD3548c:RVBD3548c,0,1,0,0,1,RV3548c,P71853,96.0677261352539
RVBD1970:lprM,1,0,0,0,1,RV1970,O53971,84.13130187988281
RVBD2272:RVBD2272,1,0,0,0,1,RV2272,P9WLF5,75.90081787109375
RVBD3654c:RVBD3654c,1,0,0,0,1,RV3654c,O69622,94.34393310546875
RVBD2597:RVBD2597,1,0,0,0,1,RV2597,P9WL73,91.03218078613281
RVBD0953c:RVBD0953c,1,0,0,0,1,RV0953c,P9WKN5,96.98457336425781
RVBD2943:RVBD2943,1,0,0,0,1,RV2943,I6X5T4,89.06155395507812
RVBD1787:PPE25,1,0,0,0,1,RV1787,P9WI13,71.65158081054688
RVBD3618:RVBD3618,1,0,0,0,1,RV3618,I6X7W8,91.4970703125
RVBD1160:mutT2,1,0,0,0,1,RV1160,P9WIY1,91.85283660888672
RVBD1867:RVBD1867,1,0,0,0,1,RV1867,P95148,96.75350189208984
RVBD0801:RVBD0801,1,0,0,0,1,RV0801,O06633,96.27800750732422
RVBD2917:RVBD2917,1,0,0,0,1,RV2917,P9WL21,76.61622619628906
RVBD0368c:RVBD0368c,1,0,0,0,1,RV0368c,O53703,76.821533203125
RVBD1036c:RVBD1036c,1,0,0,0,1,RV1036c,P96365,77.49713897705078
RVBD1703c:RVBD1703c,1,0,0,0,1,RV1703c,L0TAD5,96.20240783691406
RVBD2028c:RVBD2028c,1,0,0,0,1,RV2028c,P9WFD9,86.05803680419922
RVBD0075:RVBD0075,1,0,0,0,1,RV0075,O53620,97.26738739013672
RVBD1425:RVBD1425,0,1,0,0,1,RV1425,P9WKC1,83.52559661865234
RVBD0853c:pdc,1,0,0,0,1,RV0853c,P9WG37,94.97259521484375
RVBD2730:RVBD2730,1,0,0,0,1,RV2730,I6Y1K4,35.309749603271484
RVBD1532c:RVBD1532c,0,0,1,0,1,RV1532c,O06178,97.60354614257812
RVBD1852:ureG,1,0,0,0,1,RV1852,P9WFE3,90.75825500488281
RVBD2078:RVBD2078,1,0,0,0,1,RV2078,P9WLK9,95.31317901611328
RVBD0518:RVBD0518,0,0,1,0,1,RV0518,O33363,89.05848693847656
RVBD1804c:RVBD1804c,1,0,0,0,1,RV1804c,O53953,71.4259262084961
RVBD2274A:mazE8,1,0,0,0,1,RV2274A,P0CL60,44.33427047729492
RVBD1244:lpqZ,1,0,0,0,1,RV1244,O50459,90.60336303710938
RVBD1586c:RVBD1586c,0,1,0,0,1,RV1586c,O06604,84.14605712890625
RVBD3017c:esxQ,1,0,0,0,1,RV3017c,P9WNJ1,50.763668060302734
RVBD2565:RVBD2565,1,0,0,0,1,RV2565,P9WIY7,84.98304748535156
RVBD3292:RVBD3292,1,0,0,0,1,RV3292,P9WL01,92.04197692871094
RVBD3444c:esxT,0,0,1,0,1,RV3444c,I6YC53,84.93280029296875
RVBD1567c:RVBD1567c,1,0,0,0,1,RV1567c,O06623,77.38723754882812
RVBD1846c:RVBD1846c,1,0,0,0,1,RV1846c,P9WMJ5,88.81956481933594
RVBD3690:RVBD3690,1,0,0,0,1,RV3690,O69658,78.63340759277344
RVBD0751c:mmsB,1,0,0,0,1,RV0751c,P9WNY5,97.04122924804688
RVBD0742:PE-PGRS8,0,0,1,0,1,RV0742,I6Y8K5,92.24886322021484
RVBD3774:echA21,1,0,0,0,1,RV3774,P75019,96.60379028320312
RVBD0634c:RVBD0634c,1,0,0,0,1,RV0634c,I6Y4A5,96.87982940673828
RVBD2467:pepN,1,0,0,0,1,RV2467,L7N655,95.51673126220703
RVBD3327:RVBD3327,1,0,0,0,1,RV3327,O53377,85.7032470703125
RVBD2474c:RVBD2474c,1,0,0,0,1,RV2474c,I6X4D6,92.19396209716797
RVBD2066:cobI,0,0,1,0,1,RV2066,P9WGB3,92.56049346923828
RVBD0874c:RVBD0874c,1,0,0,0,1,RV0874c,P9WKR9,94.06507110595703
RVBD3775:lipE,0,0,1,0,1,RV3775,P72041,94.17023468017578
RVBD0151c:PE1,1,0,0,0,1,RV0151c,Q79G06,81.92061614990234
RVBD1257c:RVBD1257c,1,0,0,0,1,RV1257c,Q11061,95.83558654785156
RVBD1946c:lppG,1,0,0,0,1,RV1946c,P95268,34.233333587646484
RVBD3871:eccCb1,0,1,0,0,1,RV3871,P9WNB1,92.80322265625
RVBD1555:frdD,0,0,1,0,1,RV1555,P9WNB5,92.06647491455078
RVBD1667c:RVBD1667c,1,0,0,0,1,RV1667c,O53915,82.67990112304688
RVBD1745c:idi,1,0,0,0,1,RV1745c,P9WKK5,95.13330078125
RVBD0766c:cyp123,1,0,0,0,1,RV0766c,P9WPP5,94.53768157958984
RVBD1264:RVBD1264,1,0,0,0,1,RV1264,P9WMU9,86.77347564697266
RVBD0661c:RVBD0661c,1,0,0,0,1,RV0661c,P9WFB3,92.45958709716797
RVBD1996:RVBD1996,1,0,0,0,1,RV1996,P9WLP1,84.96031188964844
RVBD1349:irtB,1,0,0,0,1,RV1349,P9WQJ7,89.81202697753906
RVBD0727c:fucA,1,0,0,0,1,RV0727c,P95075,96.09385681152344
RVBD2692:ceoC,1,0,0,0,1,RV2692,P9WFZ3,93.51209259033203
RVBD1934c:fadE17,0,1,0,0,1,RV1934c,P95280,92.69599151611328
RVBD0514:RVBD0514,0,0,1,0,1,RV0514,O33359,68.64849090576172
RVBD3324c:moaC,1,0,0,0,1,RV3324c,P9WJR5,89.31520080566406
RVBD1108c:xseA,1,0,0,0,1,RV1108c,P9WF31,88.45498657226562
RVBD2514c:RVBD2514c,1,0,0,0,1,RV2514c,I6Y0Y0,93.56490325927734
RVBD3391:acrA1,1,0,0,0,1,RV3391,O50417,85.57386016845703
RVBD1886c:fbpB,1,0,0,0,1,RV1886c,P9WQP1,91.11006164550781
RVBD2100:RVBD2100,1,0,0,0,1,RV2100,P9WLJ3,81.0381088256836
RVBD2186c:RVBD2186c,1,0,0,0,1,RV2186c,O53520,95.0689926147461
RVBD3749Ac:RVBD3749Ac,1,0,0,0,1,RV3749Ac,,
RVBD2997:RVBD2997,0,0,1,0,1,RV2997,I6YAU3,94.8006820678711
RVBD0449c:RVBD0449c,0,0,1,0,1,RV0449c,O53734,91.67327880859375
RVBD2684:arsA,1,0,0,0,1,RV2684,P9WPD9,92.62071990966797
RVBD2940c:mas,1,0,0,0,1,RV2940c,I6Y231,87.19845581054688
RVBD0731c:RVBD0731c,1,0,0,0,1,RV0731c,P9WFI5,92.79396057128906
RVBD3076:RVBD3076,1,0,0,0,1,RV3076,I6X666,90.27000427246094
RVBD2128:RVBD2128,1,0,0,0,1,RV2128,O33262,66.88089752197266
RVBD0484c:RVBD0484c,1,0,0,0,1,RV0484c,P9WGR5,96.45657348632812
RVBD1467c:fadE15,1,0,0,0,1,RV1467c,O53158,97.41515350341797
RVBD1013:pks16,0,0,1,0,1,RV1013,O05598,92.56453704833984
RVBD2751:RVBD2751,1,0,0,0,1,RV2751,I6YEA3,93.71037292480469
RVBD2945c:lppX,1,0,0,0,1,RV2945c,P9WK65,79.4885025024414
RVBD3103c:RVBD3103c,1,0,0,0,1,RV3103c,O05780,63.63393020629883
RVBD3735:RVBD3735,1,0,0,0,1,RV3735,O69702,97.92796325683594
RVBD0170:mce1B,1,0,0,0,1,RV0170,O07414,86.53765869140625
RVBD3769:RVBD3769,1,0,0,0,1,RV3769,P72036,94.97466278076172
RVBD3563:fadE32,1,0,0,0,1,RV3563,P96845,96.47225952148438
RVBD1074c:fadA3,1,0,0,0,1,RV1074c,O53422,98.0847396850586
RVBD1405c:RVBD1405c,1,0,0,0,1,RV1405c,P9WLY7,93.71710968017578
RVBD0033:acpA,1,0,0,0,1,RV0033,I6WX95,88.81103515625
RVBD0419:lpqM,1,0,0,0,1,RV0419,P96265,87.13961791992188
RVBD2602:vapC41,1,0,0,0,1,RV2602,P9WF59,96.98746490478516
RVBD1898:RVBD1898,0,0,1,0,1,RV1898,P9WFQ1,96.64431762695312
RVBD1680:RVBD1680,1,0,0,0,1,RV1680,O33182,95.55517578125
RVBD3576:lppH,1,0,0,0,1,RV3576,I6YGJ4,89.38607788085938
RVBD2964B:RVBD2964B,1,0,0,0,1,RV2964B,,
RVBD2203:RVBD2203,1,0,0,0,1,RV2203,P9WLI7,75.27713775634766
RVBD0022c:whiB5,1,0,0,0,1,RV0022c,P71592,83.925537109375
RVBD0259c:RVBD0259c,1,0,0,0,1,RV0259c,P95216,93.60489654541016
RVBD1282c:oppC,0,0,1,0,1,RV1282c,P9WFZ9,89.53065490722656
RVBD3054c:RVBD3054c,1,0,0,0,1,RV3054c,P95105,95.15733337402344
RVBD2103c:vapC37,0,0,0,1,1,RV2103c,O53501,95.53680419921875
RVBD2069:sigC,1,0,0,0,1,RV2069,P9WGH1,86.06670379638672
RVBD0679c:RVBD0679c,1,0,0,0,1,RV0679c,I6WZ30,76.6164779663086
RVBD2020c:RVBD2020c,1,0,0,0,1,RV2020c,O53466,76.10636138916016
RVBD3578:arsB2,1,0,0,0,1,RV3578,I6YCG9,93.58842468261719
RVBD1984c:cfp21,1,0,0,0,1,RV1984c,P9WP43,90.7837905883789
RVBD3377c:RVBD3377c,0,0,1,0,1,RV3377c,O50406,92.53651428222656
RVBD1174c:TB8.4,1,0,0,0,1,RV1174c,O50430,77.7454605102539
RVBD3154:nuoJ,1,0,0,0,1,RV3154,P95172,82.82843780517578
RVBD0933:pstB,0,1,0,0,1,RV0933,P9WQK9,89.65956115722656
RVBD1258c:RVBD1258c,1,0,0,0,1,RV1258c,P9WJX9,85.80103302001953
RVBD1871c:RVBD1871c,0,1,0,0,1,RV1871c,P95144,87.0085220336914
RVBD0822c:RVBD0822c,1,0,0,0,1,RV0822c,I6WZI4,70.88159942626953
RVBD3551:RVBD3551,1,0,0,0,1,RV3551,P9WPW1,97.74605560302734
RVBD1673c:RVBD1673c,1,0,0,0,1,RV1673c,O53920,90.6048355102539
RVBD1973:RVBD1973,1,0,0,0,1,RV1973,P9WJ77,91.79862213134766
RVBD3198A:RVBD3198A,1,0,0,0,1,RV3198A,P9WN17,82.05833435058594
RVBD2459:RVBD2459,0,1,0,0,1,RV2459,P9WJW9,87.41293334960938
RVBD3088:tgs4,1,0,0,0,1,RV3088,P9WKC3,82.86766815185547
RVBD1897c:RVBD1897c,1,0,0,0,1,RV1897c,P9WNS9,97.82077026367188
RVBD2970c:lipN,0,0,0,1,1,RV2970c,P95125,90.32913970947266
RVBD1972:RVBD1972,1,0,0,0,1,RV1972,O53973,83.13591766357422
RVBD2752c:RVBD2752c,0,1,0,0,1,RV2752c,P9WGZ9,93.89261627197266
RVBD0494:RVBD0494,1,0,0,0,1,RV0494,P9WMG7,86.86235809326172
RVBD2073c:RVBD2073c,1,0,0,0,1,RV2073c,P9WGR3,95.35079956054688
RVBD0687:RVBD0687,1,0,0,0,1,RV0687,P9WGS7,96.7811279296875
RVBD1902c:nanT,1,0,0,0,1,RV1902c,O07730,90.02800750732422
RVBD1935c:echA13,1,0,0,0,1,RV1935c,P95279,93.01763916015625
RVBD2089c:pepE,1,0,0,0,1,RV2089c,P9WHS7,97.12003326416016
RVBD3268:RVBD3268,0,0,0,1,1,RV3268,P96873,96.48458099365234
RVBD3142c:RVBD3142c,1,0,0,0,1,RV3142c,P95184,90.51140594482422
RVBD2351c:plcA,1,0,0,0,1,RV2351c,P9WIB5,86.1686782836914
RVBD2856:nicT,1,0,0,0,1,RV2856,I6YEJ7,80.64476013183594
RVBD1182:papA3,1,0,0,0,1,RV1182,P9WIK5,92.97698974609375
RVBD2426c:RVBD2426c,0,0,1,0,1,RV2426c,P71922,90.2580795288086
RVBD0223c:RVBD0223c,1,0,0,0,1,RV0223c,I6X8S7,97.52103424072266
RVBD2127:ansP1,1,0,0,0,1,RV2127,P9WQM9,86.54850769042969
RVBD2181:RVBD2181,1,0,0,0,1,RV2181,P9WMZ9,91.34091186523438
RVBD3270:ctpC,0,0,1,0,1,RV3270,P9WPT5,84.17882537841797
RVBD0426c:RVBD0426c,1,0,0,0,1,RV0426c,P96272,55.15407943725586
RVBD1135A:RVBD1135A,0,0,0,1,1,RV1135A,L7N682,82.64387512207031
RVBD1921c:lppF,1,0,0,0,1,RV1921c,O53963,93.68990325927734
RVBD3637:RVBD3637,1,0,0,0,1,RV3637,O06370,91.04512023925781
RVBD3141:fadB4,1,0,0,0,1,RV3141,P95185,96.08674621582031
RVBD1354c:RVBD1354c,1,0,0,0,1,RV1354c,P9WM13,87.56547546386719
RVBD1860:apa,1,0,0,0,1,RV1860,P9WIR7,70.97962951660156
RVBD1857:modA,1,0,0,0,1,RV1857,P9WGU3,91.25765991210938
RVBD1491c:RVBD1491c,1,0,0,0,1,RV1491c,P9WFS3,74.98039245605469
RVBD1155:RVBD1155,1,0,0,0,1,RV1155,O06553,96.00163269042969
RVBD1172c:PE12,1,0,0,0,1,RV1172c,L7N693,41.72360610961914
RVBD0076c:RVBD0076c,0,1,0,0,1,RV0076c,O53621,74.8162841796875
RVBD2734:RVBD2734,1,0,0,0,1,RV2734,I6YA42,88.2043228149414
RVBD2800:RVBD2800,1,0,0,0,1,RV2800,I6YEE6,93.35985565185547
RVBD0589:mce2A,1,0,0,0,1,RV0589,Q79FY7,85.21781921386719
RVBD0799c:RVBD0799c,1,0,0,0,1,RV0799c,I6Y4U9,93.15068817138672
RVBD2923c:RVBD2923c,1,0,0,0,1,RV2923c,P9WL19,97.11431121826172
RVBD0861c:ercc3,1,0,0,0,1,RV0861c,O53873,84.37125396728516
RVBD2573:RVBD2573,1,0,0,0,1,RV2573,P9WIL1,98.12036895751953
RVBD2787:RVBD2787,1,0,0,0,1,RV2787,O33329,83.6561508178711
RVBD0560c:RVBD0560c,0,1,0,0,1,RV0560c,P9WKL5,89.95518493652344
RVBD0335c:PE6,1,0,0,0,1,RV0335c,L7N648,72.8011703491211
RVBD1372:RVBD1372,1,0,0,0,1,RV1372,P9WPF1,93.11035919189453
RVBD2691:ceoB,1,0,0,0,1,RV2691,I6XF25,87.45507049560547
RVBD2116:lppK,1,0,0,0,1,RV2116,P9WK75,72.77317810058594
RVBD2513:RVBD2513,1,0,0,0,1,RV2513,O06175,47.836143493652344
RVBD0989c:grcC2,1,0,0,0,1,RV0989c,O05572,87.477783203125
RVBD3479:RVBD3479,0,0,0,1,1,RV3479,O06342,79.80328369140625
RVBD0812:RVBD0812,0,0,1,0,1,RV0812,Q79FW0,95.3634262084961
RVBD0261c:narK3,1,0,0,0,1,RV0261c,P95218,91.90745544433594
RVBD3674c:nth,1,0,0,0,1,RV3674c,P9WQ11,96.8051528930664
RVBD0915c:PPE14,1,0,0,0,1,RV0915c,P9WI33,62.02222442626953
RVBD1220c:RVBD1220c,1,0,0,0,1,RV1220c,P9WJZ7,95.07294464111328
RVBD2621c:RVBD2621c,1,0,0,0,1,RV2621c,I6Y187,86.51468658447266
RVBD1792A:RVBD1792A,1,0,0,0,1,RV1792A,,
RVBD1329c:dinG,0,0,1,0,1,RV1329c,P9WMR5,89.4505615234375
RVBD0815c:cysA2,1,0,0,0,1,RV0815c,P9WHF9,96.6858901977539
RVBD0372c:RVBD0372c,0,1,0,0,1,RV0372c,O53707,88.7926254272461
RVBD2328:PE23,1,0,0,0,1,RV2328,P9WIG9,50.31324768066406
RVBD3206c:moeB1,0,0,0,1,1,RV3206c,P9WMN7,92.65104675292969
RVBD2005c:RVBD2005c,1,0,0,0,1,RV2005c,P9WLN1,87.79366302490234
RVBD2333c:stp,1,0,0,0,1,RV2333c,P9WG91,84.2421646118164
RVBD2781c:RVBD2781c,0,0,1,0,1,RV2781c,I6X5C5,95.89883422851562
RVBD2468A:RVBD2468A,1,0,0,0,1,RV2468A,I6YDH3,84.7718276977539
RVBD2848c:cobB,1,0,0,0,1,RV2848c,P9WP97,93.91883850097656
RVBD0125:pepA,1,0,0,0,1,RV0125,O07175,87.5932388305664
RVBD0279c:PE-PGRS4,0,1,0,0,1,RV0279c,L0T4W6,90.49531555175781
RVBD3880c:espL,0,0,1,0,1,RV3880c,P9WJB9,92.58226013183594
RVBD2120c:RVBD2120c,1,0,0,0,1,RV2120c,O33255,90.08537292480469
RVBD1814:erg3,1,0,0,0,1,RV1814,P9WNZ9,91.37076568603516
RVBD0142:RVBD0142,1,0,0,0,1,RV0142,P96819,95.0279541015625
RVBD0418:lpqL,1,0,0,0,1,RV0418,P96264,91.74607849121094
RVBD0606:RVBD0606,0,0,1,0,1,RV0606,O07772,92.322509765625
RVBD0328:RVBD0328,1,0,0,0,1,RV0328,O07252,92.05529022216797
RVBD0498:RVBD0498,0,0,1,0,1,RV0498,P9WKU1,94.64139556884766
RVBD1278:RVBD1278,0,0,1,0,1,RV1278,P9WM41,88.07485961914062
RVBD1496:RVBD1496,1,0,0,0,1,RV1496,P9WPZ1,89.14514923095703
RVBD0248c:RVBD0248c,1,0,0,0,1,RV0248c,O53670,94.68603515625
RVBD2812:RVBD2812,0,0,1,0,1,RV2812,P71639,81.86295318603516
RVBD2655c:RVBD2655c,0,1,0,0,1,RV2655c,I6Y1F0,80.28271484375
RVBD0254c:cobU,0,0,1,0,1,RV0254c,O53676,95.12735748291016
RVBD3349c:RVBD3349c,0,0,1,0,1,RV3349c,V5QQS8,60.65910720825195
RVBD3771c:RVBD3771c,0,1,0,0,1,RV3771c,P72038,85.7384262084961
RVBD2482c:plsB2,0,0,0,1,1,RV2482c,P9WI61,86.9189224243164
RVBD0872c:PE-PGRS15,1,0,0,0,1,RV0872c,Q79FV3,93.02490234375
RVBD1722:RVBD1722,1,0,0,0,1,RV1722,P71980,92.20852661132812
RVBD3225c:RVBD3225c,1,0,0,0,1,RV3225c,O05841,91.87030029296875
RVBD1361c:PPE19,1,0,0,0,1,RV1361c,P9WI25,67.2148208618164
RVBD2487c:PE-PGRS42,0,0,1,0,1,RV2487c,I6XEF1,94.30118560791016
RVBD2789c:fadE21,1,0,0,0,1,RV2789c,I6XFA9,91.67961120605469
RVBD3217c:RVBD3217c,0,0,1,0,1,RV3217c,O05849,52.330284118652344
RVBD3652:PE-PGRS60,0,0,1,0,1,RV3652,Q6MWV1,74.72432708740234
RVBD3066:RVBD3066,0,0,1,0,1,RV3066,I6X658,85.69513702392578
RVBD3501c:yrbE4A,0,0,1,0,1,RV3501c,O53546,89.16287994384766
RVBD1073:RVBD1073,1,0,0,0,1,RV1073,O53421,93.32254028320312
RVBD0266c:oplA,0,0,1,0,1,RV0266c,P95223,90.4412612915039
RVBD2341:lppQ,1,0,0,0,1,RV2341,P95237,32.68510818481445
RVBD1523:RVBD1523,1,0,0,0,1,RV1523,Q50584,71.57405853271484
RVBD3059:cyp136,0,1,0,0,1,RV3059,P9WPM7,92.8947982788086
RVBD1288:RVBD1288,0,0,1,0,1,RV1288,P9WM39,93.41685485839844
RVBD1957:RVBD1957,0,0,1,0,1,RV1957,P95257,85.70231628417969
RVBD0095c:RVBD0095c,0,0,1,0,1,RV0095c,Q10891,92.52510833740234
RVBD0508:RVBD0508,1,0,0,0,1,RV0508,P9WKS9,87.41473388671875
RVBD3920c:RVBD3920c,0,1,0,0,1,RV3920c,O53598,88.55486297607422
RVBD0276:RVBD0276,0,1,0,0,1,RV0276,O53682,89.28241729736328
RVBD3401:RVBD3401,1,0,0,0,1,RV3401,P9WN13,95.27876281738281
RVBD3556c:fadA6,1,0,0,0,1,RV3556c,I6XHJ3,97.60806274414062
RVBD3535c:hsaG,0,0,1,0,1,RV3535c,P9WQH3,95.698486328125
RVBD0831c:RVBD0831c,1,0,0,0,1,RV0831c,O53842,88.7667465209961
RVBD0939:RVBD0939,1,0,0,0,1,RV0939,O86346,94.78082275390625
RVBD2798c:RVBD2798c,1,0,0,0,1,RV2798c,P71653,90.39444732666016
RVBD1052:RVBD1052,1,0,0,0,1,RV1052,O53400,76.28216552734375
RVBD3199c:nudC,0,0,1,0,1,RV3199c,P9WIX5,92.31053924560547
RVBD1598c:RVBD1598c,1,0,0,0,1,RV1598c,O06592,81.5447769165039
RVBD2536:RVBD2536,1,0,0,0,1,RV2536,P95017,75.95791625976562
RVBD3333c:RVBD3333c,1,0,0,0,1,RV3333c,O53383,59.5204963684082
RVBD0161:RVBD0161,1,0,0,0,1,RV0161,O07406,96.17678833007812
RVBD2650c:RVBD2650c,1,0,0,0,1,RV2650c,P71947,80.28790283203125
RVBD2318:uspC,0,1,0,0,1,RV2318,P71894,94.20909118652344
RVBD3433c:RVBD3433c,0,0,1,0,1,RV3433c,P9WF11,96.39583587646484
RVBD3463:RVBD3463,0,1,0,0,1,RV3463,I6X7D4,94.09439086914062
RVBD3189:RVBD3189,1,0,0,0,1,RV3189,O53335,91.93903350830078
RVBD0192:RVBD0192,1,0,0,0,1,RV0192,O07436,80.17939758300781
RVBD0761c:adhB,1,0,0,0,1,RV0761c,P9WQC7,97.51687622070312
RVBD0052:RVBD0052,1,0,0,0,1,RV0052,I6Y6S3,95.96263122558594
RVBD1884c:rpfC,1,0,0,0,1,RV1884c,O07747,74.04778289794922
RVBD1263:amiB2,1,0,0,0,1,RV1263,P9WQ97,96.99168395996094
RVBD3403c:RVBD3403c,1,0,0,0,1,RV3403c,P9WKZ5,92.91162872314453
RVBD2131c:cysQ,1,0,0,0,1,RV2131c,P9WKJ1,93.42366790771484
RVBD3803c:fbpD,1,0,0,0,1,RV3803c,P9WQN7,92.4867935180664
RVBD0081:RVBD0081,0,1,0,0,1,RV0081,P9WMI7,93.35211944580078
RVBD2827c:RVBD2827c,0,0,1,0,1,RV2827c,P71625,95.97969055175781
RVBD1772:RVBD1772,1,0,0,0,1,RV1772,O06805,83.956298828125
RVBD0389:purT,1,0,0,0,1,RV0389,P95197,87.55740356445312
RVBD1816:RVBD1816,0,1,0,0,1,RV1816,P9WMC9,94.85948181152344
RVBD0299:RVBD0299,1,0,0,0,1,RV0299,O07226,91.45040130615234
RVBD2530c:vapC39,1,0,0,0,1,RV2530c,P9WF63,94.26351928710938
RVBD0103c:ctpB,1,0,0,0,1,RV0103c,P9WPT9,82.42583465576172
RVBD3445c:esxU,1,0,0,0,1,RV3445c,I6Y3I6,91.85971069335938
RVBD0966c:RVBD0966c,1,0,0,0,1,RV0966c,P9WKM1,74.88170623779297
RVBD0342:iniA,1,0,0,0,1,RV0342,P9WJ99,78.36534118652344
RVBD2918c:glnD,1,0,0,0,1,RV2918c,P9WN29,87.56527709960938
RVBD1033c:trcR,1,0,0,0,1,RV1033c,L7N689,83.16876220703125
RVBD2731:RVBD2731,1,0,0,0,1,RV2731,I6XF60,87.229736328125
RVBD2854:RVBD2854,1,0,0,0,1,RV2854,O05805,92.02162170410156
RVBD1527c:pks5,1,0,0,0,1,RV1527c,O53901,87.16675567626953
RVBD3238c:RVBD3238c,1,0,0,0,1,RV3238c,O05883,93.994140625
RVBD0618:galTa,1,0,0,0,1,RV0618,Q79FY4,76.12818908691406
RVBD2576c:RVBD2576c,0,1,0,0,1,RV2576c,P9WL83,77.83019256591797
RVBD2966c:RVBD2966c,1,0,0,0,1,RV2966c,I6XFS7,93.19830322265625
RVBD2934:ppsD,0,0,0,1,1,RV2934,P9WQE3,84.9931869506836
RVBD3060c:RVBD3060c,1,0,0,0,1,RV3060c,P95098,86.84679412841797
RVBD2064:cobG,1,0,0,0,1,RV2064,Q10675,94.09700012207031
RVBD2298:RVBD2298,1,0,0,0,1,RV2298,P9WQA7,94.0890121459961
RVBD0190:RVBD0190,1,0,0,0,1,RV0190,O07434,91.54656982421875
RVBD3537:kstD,1,0,0,0,1,RV3537,P71864,96.28230285644531
RVBD0927c:RVBD0927c,1,0,0,0,1,RV0927c,P9WGQ5,96.49185943603516
RVBD2315c:RVBD2315c,0,1,0,0,1,RV2315c,P71897,96.80274200439453
RVBD2331A:RVBD2331A,1,0,0,0,1,RV2331A,Q79FF7,46.00115966796875
RVBD3432c:gadB,1,0,0,0,1,RV3432c,I6YG46,92.31024169921875
RVBD1670:RVBD1670,0,1,0,0,1,RV1670,O53917,91.25948333740234
RVBD3431c:RVBD3431c,0,1,0,0,1,RV3431c,I6XH73,92.08512115478516
RVBD2531c:RVBD2531c,1,0,0,0,1,RV2531c,I6X4K0,88.25720977783203
RVBD0481c:RVBD0481c,1,0,0,0,1,RV0481c,P9WKV5,94.98139190673828
RVBD2705c:RVBD2705c,1,0,0,0,1,RV2705c,O07206,90.68511199951172
RVBD1376:RVBD1376,1,0,0,0,1,RV1376,P71804,89.02764129638672
RVBD1334:mec,0,1,0,0,1,RV1334,P9WHS1,94.62075805664062
RVBD1232c:RVBD1232c,1,0,0,0,1,RV1232c,O86315,86.70246124267578
RVBD3553:RVBD3553,1,0,0,0,1,RV3553,P71847,91.54842376708984
RVBD0506:mmpS2,1,0,0,0,1,RV0506,P9WJT3,84.9736557006836
RVBD3223c:sigH,1,0,0,0,1,RV3223c,P9WGH9,78.0927734375
RVBD3750c:RVBD3750c,1,0,0,0,1,RV3750c,O69717,93.20384979248047
RVBD1888c:RVBD1888c,0,0,0,1,1,RV1888c,O07744,81.27574920654297
RVBD2310:RVBD2310,1,0,0,0,1,RV2310,P9WLC3,90.8800048828125
RVBD3606c:folK,0,0,0,1,1,RV3606c,P9WNC7,91.28883361816406
RVBD0904c:accD3,1,0,0,0,1,RV0904c,P9WQH9,94.69490051269531
RVBD1157c:RVBD1157c,1,0,0,0,1,RV1157c,O06555,66.51765441894531
RVBD1817:RVBD1817,1,0,0,0,1,RV1817,Q50616,96.70587921142578
RVBD0540:RVBD0540,1,0,0,0,1,RV0540,O06406,97.55087280273438
RVBD3079c:RVBD3079c,0,1,0,0,1,RV3079c,I6XG43,96.26610565185547
RVBD2481c:RVBD2481c,1,0,0,0,1,RV2481c,O53206,36.96084213256836
RVBD0805:RVBD0805,0,0,0,1,1,RV0805,P9WP65,93.51949310302734
Empty,0,0,0,1,1,Emy,,
RVBD1810:RVBD1810,0,0,1,0,1,RV1810,O07222,68.99949645996094
RVBD3825c:pks2,0,1,0,0,1,RV3825c,P9WQE9,85.68702697753906
RVBD0866:moaE2,1,0,0,0,1,RV0866,P9WJR1,96.59233856201172
RVBD1346:mbtN,1,0,0,0,1,RV1346,P9WQF9,95.4517593383789
RVBD1058:fadD14,1,0,0,0,1,RV1058,O53406,93.42366027832031
RVBD3364c:RVBD3364c,1,0,0,0,1,RV3364c,O50393,90.89307403564453
RVBD1427c:fadD12,0,0,0,1,1,RV1427c,O06831,88.69481658935547
RVBD3108:RVBD3108,1,0,0,0,1,RV3108,O05785,43.75300979614258
RVBD2356c:PPE40,1,0,0,0,1,RV2356c,P9WHZ7,91.97808074951172
RVBD2015c:RVBD2015c,0,0,1,0,1,RV2015c,O53461,83.22718048095703
RVBD1270c:lprA,1,0,0,0,1,RV1270c,P9WK55,88.62090301513672
RVBD1107c:xseB,1,0,0,0,1,RV1107c,P9WF29,87.25753021240234
RVBD3405c:RVBD3405c,0,0,1,0,1,RV3405c,P9WMC3,89.89419555664062
RVBD1743:pknE,1,0,0,0,1,RV1743,P9WI77,83.62525177001953
RVBD2823c:RVBD2823c,1,0,0,0,1,RV2823c,P71629,87.404541015625
RVBD1802:PPE30,1,0,0,0,1,RV1802,P9WI07,68.21147155761719
RVBD0490:senX3,1,0,0,0,1,RV0490,P9WGK5,82.93339538574219
RVBD0365c:RVBD0365c,1,0,0,0,1,RV0365c,O06315,95.26866912841797
RVBD0012:RVBD0012,1,0,0,0,1,RV0012,L0T243,85.69438934326172
RVBD2972c:RVBD2972c,0,0,1,0,1,RV2972c,I6X5W6,91.7928695678711
RVBD1596:nadC,1,0,0,0,1,RV1596,P9WJJ7,97.50965118408203
RVBD3148:nuoD,1,0,0,0,1,RV3148,P9WJH5,88.00627899169922
RVBD2392:cysH,1,0,0,0,1,RV2392,P9WIK3,91.93594360351562
RVBD0557:mgtA,1,0,0,0,1,RV0557,P9WMY5,92.07405090332031
RVBD1508c:RVBD1508c,1,0,0,0,1,RV1508c,P71787,78.77967071533203
RVBD2989:RVBD2989,1,0,0,0,1,RV2989,O53238,95.46561431884766
RVBD0755c:PPE12,1,0,0,0,1,RV0755c,P9WI37,91.46714782714844
RVBD2290:lppO,1,0,0,0,1,RV2290,P9WK71,82.64801788330078
RVBD0193c:RVBD0193c,1,0,0,0,1,RV0193c,O07437,88.91725158691406
RVBD1968:mce3C,1,0,0,0,1,RV1968,O53969,76.67029571533203
RVBD0565c:RVBD0565c,1,0,0,0,1,RV0565c,O53762,94.99717712402344
RVBD3344c:PE-PGRS49,0,0,1,0,1,RV3344c,L0TFC2,70.72752380371094
RVBD1775:RVBD1775,1,0,0,0,1,RV1775,O33178,94.45779418945312
RVBD0397:RVBD0397,0,1,0,0,1,RV0397,P95205,79.02508544921875
RVBD1352:RVBD1352,0,0,1,0,1,RV1352,P9WM15,85.39787292480469
RVBD3577:RVBD3577,1,0,0,0,1,RV3577,P96859,96.74909973144531
RVBD2418c:RVBD2418c,1,0,0,0,1,RV2418c,P71725,94.30210876464844
RVBD0743c:RVBD0743c,0,0,0,1,1,RV0743c,I6WZ83,92.64248657226562
RVBD3383c:idsB,0,0,1,0,1,RV3383c,O50410,92.38959503173828
RVBD3851:RVBD3851,1,0,0,0,1,RV3851,P96226,71.27371978759766
RVBD2021c:RVBD2021c,0,0,1,0,1,RV2021c,O53467,94.89712524414062
RVBD1564c:treX,1,0,0,0,1,RV1564c,P9WQ25,93.02043914794922
RVBD1645c:RVBD1645c,1,0,0,0,1,RV1645c,P94979,85.07467651367188
RVBD0177:RVBD0177,1,0,0,0,1,RV0177,O07421,86.4902114868164
RVBD0644c:mmaA2,0,1,0,0,1,RV0644c,Q79FX6,95.34626770019531
RVBD3198c:uvrD2,0,0,1,0,1,RV3198c,P9WMP9,87.76959991455078
RVBD3550:echA20,0,0,1,0,1,RV3550,I6Y3U6,95.91790771484375
RVBD3242c:RVBD3242c,0,1,0,0,1,RV3242c,O05887,88.83074951171875
RVBD3365c:RVBD3365c,1,0,0,0,1,RV3365c,Q93IG6,75.99706268310547
RVBD0730:RVBD0730,1,0,0,0,1,RV0730,I6XW38,84.1436767578125
RVBD3633:RVBD3633,1,0,0,0,1,RV3633,P9WI89,94.88780975341797
RVBD2302:RVBD2302,1,0,0,0,1,RV2302,P9WLD5,75.37049865722656
RVBD2146c:RVBD2146c,1,0,0,0,1,RV2146c,O06230,93.02312469482422
RVBD0660c:mazE2,0,0,1,0,1,RV0660c,O06779,88.12110900878906
RVBD2026c:RVBD2026c,1,0,0,0,1,RV2026c,P9WFD1,86.26040649414062
RVBD2501c:accA1,0,0,1,0,1,RV2501c,P9WPQ3,92.98114776611328
RVBD0654:RVBD0654,1,0,0,0,1,RV0654,P9WPR5,89.82546997070312
RVBD1455:RVBD1455,0,0,1,0,1,RV1455,O53147,93.01972198486328
RVBD2836c:dinF,1,0,0,0,1,RV2836c,P71616,93.9512939453125
RVBD0073:RVBD0073,1,0,0,0,1,RV0073,P9WQK5,88.63139343261719
RVBD3529c:RVBD3529c,1,0,0,0,1,RV3529c,I6YCC4,94.50460815429688
RVBD0889c:citA,1,0,0,0,1,RV0889c,P9WPD3,93.9907455444336
RVBD3243c:RVBD3243c,1,0,0,0,1,RV3243c,O05888,84.21239471435547
RVBD0456A:mazF1,0,0,1,0,1,RV0456A,Q6MX40,66.7029037475586
RVBD3707c:RVBD3707c,0,1,0,0,1,RV3707c,I6Y4C4,96.22318267822266
RVBD1146:mmpL13b,1,0,0,0,1,RV1146,O06546,78.28276062011719
RVBD2009:vapB15,0,1,0,0,1,RV2009,P9WLM7,84.53887176513672
RVBD1192:RVBD1192,1,0,0,0,1,RV1192,O05294,89.38665771484375
RVBD2835c:ugpA,1,0,0,0,1,RV2835c,I6XFF3,91.22418975830078
RVBD0327c:cyp135A1,1,0,0,0,1,RV0327c,P9WPN1,91.06714630126953
RVBD2036:RVBD2036,0,0,1,0,1,RV2036,O53480,93.87089538574219
RVBD1718:RVBD1718,1,0,0,0,1,RV1718,P71976,97.05316162109375
RVBD0448c:RVBD0448c,1,0,0,0,1,RV0448c,O53733,81.31502532958984
RVBD3848:RVBD3848,1,0,0,0,1,RV3848,P96229,75.31582641601562
RVBD3737:RVBD3737,1,0,0,0,1,RV3737,O69704,79.16065979003906
RVBD2381c:mbtD,1,0,0,0,1,RV2381c,P71719,87.87893676757812
RVBD0625c:RVBD0625c,1,0,0,0,1,RV0625c,P9WFS5,78.29784393310547
RVBD2687c:RVBD2687c,0,1,0,0,1,RV2687c,P9WJB1,95.10987854003906
RVBD3870:eccCa1,1,0,0,0,1,RV3870,P9WNB3,83.53141784667969
RVBD1185c:fadD21,1,0,0,0,1,RV1185c,P9WQ49,90.66416931152344
RVBD1418:lprH,1,0,0,0,1,RV1418,P9WK43,83.88679504394531
RVBD0750:RVBD0750,0,0,1,0,1,RV0750,O53813,58.203216552734375
RVBD3853:menG,1,0,0,0,1,RV3853,P9WGY3,98.09770202636719
RVBD0173:lprK,1,0,0,0,1,RV0173,O07417,84.88025665283203
RVBD3574:kstR,0,0,1,0,1,RV3574,P96856,88.31763458251953
RVBD2267c:RVBD2267c,1,0,0,0,1,RV2267c,P9WLG1,88.70574188232422
RVBD3605c:RVBD3605c,1,0,0,0,1,RV3605c,O06277,62.32088088989258
RVBD2007c:fdxA,0,0,1,0,1,RV2007c,P9WNE7,95.75614929199219
RVBD2515c:RVBD2515c,0,0,0,1,1,RV2515c,I6XEH5,84.2693862915039
RVBD1489:RVBD1489,1,0,0,0,1,RV1489,L7N692,94.38687896728516
RVBD2471:aglA,1,0,0,0,1,RV2471,O53198,93.29368591308594
RVBD3269:RVBD3269,1,0,0,0,1,RV3269,P96874,87.63333129882812
RVBD3388:PE-PGRS52,0,0,1,0,1,RV3388,Q6MWX5,92.6283950805664
RVBD3271c:RVBD3271c,1,0,0,0,1,RV3271c,P96876,81.5401382446289
RVBD1187:rocA,1,0,0,0,1,RV1187,O50443,97.82830810546875
RVBD3216:RVBD3216,0,0,1,0,1,RV3216,,
RVBD2076c:RVBD2076c,1,0,0,0,1,RV2076c,P9WLL3,58.70710754394531
RVBD2275:RVBD2275,1,0,0,0,1,RV2275,P9WPF9,83.20467376708984
RVBD1666c:cyp139,1,0,0,0,1,RV1666c,P9WPM1,93.98548126220703
RVBD2532c:RVBD2532c,0,0,1,0,1,RV2532c,P95021,76.69503021240234
RVBD1986:RVBD1986,1,0,0,0,1,RV1986,P9WK31,88.9043197631836
RVBD3733c:RVBD3733c,0,0,1,0,1,RV3733c,O69700,94.32584381103516
RVBD1807:PPE31,1,0,0,0,1,RV1807,L0T7Y7,69.6725082397461
RVBD3885c:eccE2,1,0,0,0,1,RV3885c,P9WJE7,88.10502624511719
RVBD0568:cyp135B1,1,0,0,0,1,RV0568,P9WPM9,89.80987548828125
RVBD2065:cobH,1,0,0,0,1,RV2065,P9WP87,97.41609954833984
RVBD1635c:RVBD1635c,1,0,0,0,1,RV1635c,O06152,89.51844787597656
RVBD1006:RVBD1006,1,0,0,0,1,RV1006,O05592,90.35049438476562
RVBD3037c:RVBD3037c,1,0,0,0,1,RV3037c,P9WJZ3,94.77273559570312
RVBD3700c:RVBD3700c,1,0,0,0,1,RV3700c,O69668,94.99032592773438
RVBD3016:lpqA,1,0,0,0,1,RV3016,I6Y2A3,88.79627990722656
RVBD1628c:RVBD1628c,1,0,0,0,1,RV1628c,O06145,90.81454467773438
RVBD2345:RVBD2345,1,0,0,0,1,RV2345,P9WFJ5,85.876953125
RVBD2713:sthA,1,0,0,0,1,RV2713,P9WHH5,95.51343536376953
RVBD2953:RVBD2953,0,0,0,1,1,RV2953,P9WGV5,94.91426086425781
RVBD0312:RVBD0312,1,0,0,0,1,RV0312,O07239,73.23717498779297
RVBD2491:RVBD2491,0,0,1,0,1,RV2491,I6XEF6,85.32150268554688
RVBD0869c:moaA2,0,0,1,0,1,RV0869c,P9WJS1,91.27277374267578
RVBD0501:galE2,1,0,0,0,1,RV0501,P9WKT3,83.40174865722656
RVBD0686:RVBD0686,1,0,0,0,1,RV0686,I6XVZ6,88.28048706054688
RVBD3656c:RVBD3656c,0,0,1,0,1,RV3656c,O69624,92.80323028564453
RVBD1888A:RVBD1888A,0,0,1,0,1,RV1888A,Q79FJ0,95.62035369873047
RVBD2039c:RVBD2039c,1,0,0,0,1,RV2039c,O53483,89.1771469116211
RVBD1319c:RVBD1319c,1,0,0,0,1,RV1319c,P9WQ31,87.36661529541016
RVBD0916c:PE7,0,0,0,1,1,RV0916c,I6Y936,88.17728424072266
RVBD0728c:serA2,0,0,1,0,1,RV0728c,I6WZ71,96.75675201416016
RVBD2307D:RVBD2307D,1,0,0,0,1,RV2307D,L7N683,58.60499954223633
RVBD2433c:RVBD2433c,0,0,1,0,1,RV2433c,P71916,85.5339584350586
RVBD0759c:RVBD0759c,1,0,0,0,1,RV0759c,P9WML3,97.5869140625
RVBD2393:che1,1,0,0,0,1,RV2393,P71751,86.95423126220703
RVBD0520:RVBD0520,1,0,0,0,1,RV0520,O33365,96.2529296875
RVBD1505c:RVBD1505c,1,0,0,0,1,RV1505c,P71784,97.75456237792969
RVBD0757:phoP,1,0,0,0,1,RV0757,P71814,81.73359680175781
RVBD1966:mce3A,1,0,0,0,1,RV1966,L7N698,83.7052230834961
RVBD3821:RVBD3821,1,0,0,0,1,RV3821,O07802,68.51155853271484
RVBD2624c:RVBD2624c,1,0,0,0,1,RV2624c,P9WFD5,86.81474304199219
RVBD2906c:trmD,1,0,0,0,1,RV2906c,P9WFY7,96.09474182128906
RVBD2739c:RVBD2739c,1,0,0,0,1,RV2739c,O33282,93.64606475830078
RVBD3293:pcd,1,0,0,0,1,RV3293,L7N650,97.10713195800781
RVBD3896c:RVBD3896c,0,0,0,1,1,RV3896c,O05448,80.94241333007812
RVBD1470:trxA,0,1,0,0,1,RV1470,O53161,90.77459716796875
RVBD3744:nmtR,0,0,1,0,1,RV3744,O69711,80.97016906738281
RVBD2776c:RVBD2776c,1,0,0,0,1,RV2776c,O86347,94.2252426147461
RVBD2499c:RVBD2499c,1,0,0,0,1,RV2499c,I6Y9H2,90.06718444824219
RVBD0257:RVBD0257,1,0,0,0,1,RV0257,L7N694,45.631690979003906
RVBD2395:RVBD2395,1,0,0,0,1,RV2395,P71749,86.09794616699219
RVBD0778:cyp126,1,0,0,0,1,RV0778,P9WPN9,91.24152374267578
RVBD0253:nirD,1,0,0,0,1,RV0253,O53675,95.20626068115234
RVBD1644:tsnR,1,0,0,0,1,RV1644,P94978,95.50180053710938
RVBD0585c:RVBD0585c,1,0,0,0,1,RV0585c,O53781,83.23986053466797
RVBD0405:pks6,0,0,1,0,1,RV0405,O86335,84.51754760742188
RVBD0399c:lpqK,0,0,1,0,1,RV0399c,P95207,92.6903305053711
RVBD0741:RVBD0741,1,0,0,0,1,RV0741,I6X9N4,89.07298278808594
RVBD1728c:RVBD1728c,0,1,0,0,1,RV1728c,P71986,79.71429443359375
RVBD0787:RVBD0787,1,0,0,0,1,RV0787,P71840,72.34529113769531
RVBD3093c:RVBD3093c,1,0,0,0,1,RV3093c,O05772,94.19320678710938
RVBD2339:mmpL9,1,0,0,0,1,RV2339,P9WJU3,84.59760284423828
RVBD0198c:zmp1,0,1,0,0,1,RV0198c,I6X8R2,96.5270767211914
RVBD2619c:RVBD2619c,1,0,0,0,1,RV2619c,O06194,92.83804321289062
RVBD3882c:eccE1,0,0,0,1,1,RV3882c,P9WJE9,89.90287780761719
RVBD0319:pcp,0,0,1,0,1,RV0319,P9WIJ5,97.01216125488281
RVBD1960c:RVBD1960c,1,0,0,0,1,RV1960c,P9WIJ7,94.76253509521484
RVBD3561:fadD3,1,0,0,0,1,RV3561,P96843,91.33753967285156
RVBD2623:TB31.7,0,0,1,0,1,RV2623,P9WFD7,89.13275909423828
RVBD2716:RVBD2716,1,0,0,0,1,RV2716,P9WL43,96.22798156738281
RVBD3454:RVBD3454,1,0,0,0,1,RV3454,O06321,87.71390533447266
RVBD1280c:oppA,0,1,0,0,1,RV1280c,P9WGU5,89.6893539428711
RVBD1368:lprF,0,1,0,0,1,RV1368,P9WK47,87.38134002685547
RVBD0116c:ldtA,1,0,0,0,1,RV0116c,O53638,90.33338165283203
RVBD2919c:glnB,1,0,0,0,1,RV2919c,P9WN31,93.40428161621094
RVBD2574:RVBD2574,1,0,0,0,1,RV2574,P9WL87,91.79442596435547
RVBD0846c:RVBD0846c,1,0,0,0,1,RV0846c,I6WZK7,90.45423889160156
RVBD0460:RVBD0460,1,0,0,0,1,RV0460,O53745,66.66557312011719
RVBD3615c:espC,1,0,0,0,1,RV3615c,P9WJD7,93.05905151367188
RVBD1913:RVBD1913,1,0,0,0,1,RV1913,O07720,94.40640258789062
RVBD2123:PPE37,1,0,0,0,1,RV2123,Q79FH3,66.9109115600586
RVBD3080c:pknK,1,0,0,0,1,RV3080c,P9WI65,84.03665161132812
RVBD2818c:RVBD2818c,1,0,0,0,1,RV2818c,P71635,91.89744567871094
RVBD1521:fadD25,1,0,0,0,1,RV1521,P9WQ45,90.33617401123047
RVBD0068:RVBD0068,0,0,1,0,1,RV0068,O53613,93.09465026855469
RVBD2269c:RVBD2269c,1,0,0,0,1,RV2269c,P9WLF9,32.83354568481445
RVBD2723:RVBD2723,1,0,0,0,1,RV2723,P9WG93,80.14697265625
RVBD2402:RVBD2402,1,0,0,0,1,RV2402,P71741,89.23200225830078
RVBD1081c:RVBD1081c,0,1,0,0,1,RV1081c,O53429,92.913330078125
RVBD2942:mmpL7,1,0,0,0,1,RV2942,P9WJU7,76.42831420898438
RVBD2216:RVBD2216,1,0,0,0,1,RV2216,P9WGP7,95.78933715820312
RVBD3653:PE-PGRS61,1,0,0,0,1,RV3653,Q6MWV0,93.84302520751953
RVBD3099c:RVBD3099c,0,1,0,0,1,RV3099c,O05777,95.45943450927734
RVBD0623:vapB30,1,0,0,0,1,RV0623,P9WJ35,89.57892608642578
RVBD1989c:RVBD1989c,0,0,0,0,0,RV1989c,P9WLP9,96.11590576171875
RVBD3554:fdxB,0,0,0,0,0,RV3554,P71846,88.09375
RVBD2114:RVBD2114,0,0,0,0,0,RV2114,O33249,92.4773941040039
RVBD2745c:clgR,0,0,0,0,0,RV2745c,P9WMH7,90.05232238769531
RVBD3424c:RVBD3424c,0,0,0,0,0,RV3424c,P9WKY3,30.147499084472656
RVBD3202A:RVBD3202A,0,0,0,0,0,RV3202A,P0DMM3,65.87374877929688
RVBD1535:RVBD1535,0,0,0,0,0,RV1535,O06180,67.30281829833984
RVBD0964c:RVBD0964c,0,0,0,0,0,RV0964c,P9WKM5,70.73500061035156
RVBD0601c:RVBD0601c,0,0,0,0,0,RV0601c,O07777,81.4570541381836
RVBD2019:RVBD2019,0,0,0,0,0,RV2019,O53465,91.07499694824219
RVBD2714:RVBD2714,0,0,0,0,0,RV2714,I6YA29,88.34605407714844
RVBD3891c:esxD,0,0,0,0,0,RV3891c,O05453,86.25916290283203
RVBD2285:RVBD2285,0,0,0,0,0,RV2285,P9WKB5,88.82807159423828
RVBD3090:RVBD3090,0,0,0,0,0,RV3090,O05769,83.04426574707031
RVBD0566c:RVBD0566c,0,0,0,0,0,RV0566c,P9WFK9,94.27570343017578
RVBD2209:RVBD2209,0,0,0,0,0,RV2209,P9WLI3,69.60714721679688
RVBD3393:iunH,0,0,0,0,0,RV3393,O50418,96.61243438720703
RVBD1813c:RVBD1813c,0,0,0,0,0,RV1813c,P9WLS1,82.05209350585938
RVBD1286:cysN,0,0,0,0,0,RV1286,P9WNM5,87.16220092773438
RVBD1139c:RVBD1139c,0,0,0,0,0,RV1139c,O06539,92.19873809814453
RVBD2808:RVBD2808,0,0,0,0,0,RV2808,P71643,96.19564819335938
RVBD3536c:hsaE,0,0,0,0,0,RV3536c,I6XHH5,97.24324798583984
RVBD3874:esxB,0,0,0,0,0,RV3874,P9WNK5,86.69760131835938
RVBD3483c:RVBD3483c,0,0,0,0,0,RV3483c,I6X7F2,80.22327423095703
RVBD2695:RVBD2695,0,0,0,0,0,RV2695,I6Y1I1,97.34468078613281
RVBD2542:RVBD2542,0,0,0,0,0,RV2542,P95011,72.87513732910156
RVBD3539:PPE63,0,0,0,0,0,RV3539,P9WHX5,84.1006088256836
RVBD2042c:RVBD2042c,0,0,0,0,0,RV2042c,O53486,94.02871704101562
RVBD1570:bioD,0,0,0,0,0,RV1570,P9WPQ5,98.0873031616211
RVBD2082:RVBD2082,0,0,0,0,0,RV2082,Q10690,68.56378936767578
RVBD2360c:RVBD2360c,0,0,0,0,0,RV2360c,O05838,92.3848648071289
RVBD3565:aspB,0,0,0,0,0,RV3565,P96847,96.37641906738281
RVBD2237A:RVBD2237A,0,0,0,0,0,RV2237A,I6XDU8,68.87935638427734
RVBD1754c:RVBD1754c,0,0,0,0,0,RV1754c,O06790,74.9067153930664
RVBD1906c:RVBD1906c,0,0,0,0,0,RV1906c,O07726,77.8587875366211
RVBD2931:ppsA,0,0,0,0,0,RV2931,P9WQE7,82.92384338378906
RVBD1749c:RVBD1749c,0,0,0,0,0,RV1749c,O65935,89.44237518310547
RVBD1577c:RVBD1577c,0,0,0,0,0,RV1577c,O06613,90.6898193359375
RVBD0152c:PE2,0,0,0,0,0,RV0152c,Q79G05,73.06592559814453
RVBD0345:RVBD0345,0,0,0,0,0,RV0345,O06296,85.32574462890625
RVBD1753c:PPE24,0,0,0,0,0,RV1753c,P9WI15,68.1170883178711
RVBD1101c:RVBD1101c,0,0,0,0,0,RV1101c,P9WFM3,78.14329528808594
RVBD3729:RVBD3729,0,0,0,0,0,RV3729,O69696,85.5386962890625
RVBD2041c:RVBD2041c,0,0,0,0,0,RV2041c,O53485,90.21015167236328
RVBD0021c:RVBD0021c,0,0,0,0,0,RV0021c,P71591,95.79351043701172
RVBD1572c:RVBD1572c,0,0,0,0,0,RV1572c,O06618,70.0702896118164
RVBD1032c:trcS,0,0,0,0,0,RV1032c,P96368,87.25212097167969
RVBD1939:RVBD1939,0,0,0,0,0,RV1939,P95275,94.43701934814453
RVBD2773c:dapB,0,0,0,0,0,RV2773c,P9WP23,97.01570129394531
RVBD0992c:RVBD0992c,0,0,0,0,0,RV0992c,O05575,91.77995300292969
RVBD3067:RVBD3067,0,0,0,0,0,RV3067,I6YB21,73.31298828125
RVBD3138:pflA,0,0,0,0,0,RV3138,P95188,94.6788330078125
RVBD3089:fadD13,0,0,0,0,0,RV3089,P9WQ37,91.6358413696289
RVBD3818:RVBD3818,0,0,0,0,0,RV3818,P9WH21,94.30126953125
RVBD0310c:RVBD0310c,0,0,0,0,0,RV0310c,O07237,92.46987915039062
RVBD1568:bioA,0,0,0,0,0,RV1568,P9WQ81,95.5386962890625
RVBD0945:RVBD0945,0,0,0,0,0,RV0945,P9WGR7,93.45628356933594
RVBD1702c:RVBD1702c,0,0,0,0,0,RV1702c,P9WLT3,89.52560424804688
RVBD1163:narJ,0,0,0,0,0,RV1163,O06561,90.75746154785156
RVBD2117:RVBD2117,0,0,0,0,0,RV2117,O33252,97.66515350341797
RVBD1102c:mazF3,0,0,0,0,0,RV1102c,P9WIH9,95.97844696044922
RVBD3050c:RVBD3050c,0,0,0,0,0,RV3050c,I6XG13,88.51934051513672
RVBD3033:RVBD3033,0,0,0,0,0,RV3033,I6YAY5,86.57801818847656
RVBD3084:lipR,0,0,0,0,0,RV3084,P9WK85,94.66444396972656
RVBD3572:RVBD3572,0,0,0,0,0,RV3572,I6X7P2,89.20165252685547
RVBD0926c:RVBD0926c,0,0,0,0,0,RV0926c,I6WZS8,96.70231628417969
RVBD3893c:PE36,0,0,0,0,0,RV3893c,L7N660,95.35792541503906
RVBD1942c:mazF5,0,0,0,0,0,RV1942c,P95272,94.88459777832031
RVBD2799:RVBD2799,0,0,0,0,0,RV2799,I6XFB7,77.47358703613281
RVBD1317c:alkA,0,0,0,0,0,RV1317c,P9WJW3,93.61627197265625
RVBD0341:iniB,0,0,0,0,0,RV0341,P9WJ97,41.83989715576172
RVBD2225:panB,0,0,0,0,0,RV2225,P9WIL7,93.6500015258789
RVBD0162c:adhE1,0,0,0,0,0,RV0162c,L7N6B3,94.87467193603516
RVBD2431c:PE25,0,0,0,0,0,RV2431c,I6X486,95.81434631347656
RVBD1439c:RVBD1439c,0,0,0,0,0,RV1439c,O06820,88.81574249267578
RVBD3623:lpqG,0,0,0,0,0,RV3623,I6X7X3,85.90438079833984
RVBD3589:mutY,0,0,0,0,0,RV3589,P9WQ09,93.13020324707031
RVBD2622:RVBD2622,0,0,0,0,0,RV2622,I6XES4,91.10391998291016
RVBD3911:sigM,0,0,0,0,0,RV3911,O53590,81.98081970214844
RVBD1651c:PE-PGRS30,0,0,0,0,0,RV1651c,Q79FL8,
RVBD1356c:RVBD1356c,0,0,0,0,0,RV1356c,P9WM09,87.93338775634766
RVBD1448c:tal,0,0,0,0,0,RV1448c,P9WG33,97.0575180053711
RVBD3178:RVBD3178,0,0,0,0,0,RV3178,O53328,89.20109558105469
RVBD3840:RVBD3840,0,0,0,0,0,RV3840,P96238,70.89891052246094
RVBD1316c:ogt,0,0,0,0,0,RV1316c,P9WJW5,94.3327865600586
RVBD1959c:parE1,0,0,0,0,0,RV1959c,P9WHG7,92.40276336669922
RVBD1151c:RVBD1151c,0,0,0,0,0,RV1151c,P9WGG3,94.31752014160156
RVBD2929:RVBD2929,0,0,0,0,0,RV2929,P9WL13,39.56640625
RVBD3833:RVBD3833,0,0,0,0,0,RV3833,P96245,86.28870391845703
RVBD0422c:thiD,0,0,0,0,0,RV0422c,P9WG77,94.81837463378906
RVBD2455c:RVBD2455c,0,0,0,0,0,RV2455c,O53182,91.8786849975586
RVBD1866:RVBD1866,0,0,0,0,0,RV1866,P95149,93.16952514648438
RVBD1929c:RVBD1929c,0,0,0,0,0,RV1929c,P95285,94.90133666992188
RVBD1140:RVBD1140,0,0,0,0,0,RV1140,O06540,81.03666687011719
RVBD0043c:RVBD0043c,0,0,0,0,0,RV0043c,P9WMG9,87.4120101928711
RVBD2596:RVBD2596,0,0,0,0,0,RV2596,P9WF61,96.73471069335938
RVBD2219A:RVBD2219A,0,0,0,0,0,RV2219A,Q79FG7,80.54035949707031
RVBD3437:RVBD3437,0,0,0,0,0,RV3437,I6YG51,58.304874420166016
RVBD1333:RVBD1333,0,0,0,0,0,RV1333,P9WM23,95.2964859008789
RVBD3416:whiB3,0,0,0,0,0,RV3416,P9WF41,86.38031005859375
RVBD1706A:RVBD1706A,0,0,0,0,0,RV1706A,Q79FL4,55.98128128051758
RVBD0740:RVBD0740,0,0,0,0,0,RV0740,O53803,85.1444091796875
RVBD1910c:RVBD1910c,0,0,0,0,0,RV1910c,P9WFN5,84.63426971435547
RVBD1624c:RVBD1624c,0,0,0,0,0,RV1624c,O06141,62.71051788330078
RVBD0598c:vapC27,0,0,0,0,0,RV0598c,P9WF83,96.79949188232422
RVBD2633c:RVBD2633c,0,0,0,0,0,RV2633c,P9WL59,95.8343505859375
RVBD2454c:RVBD2454c,0,0,0,0,0,RV2454c,O53181,92.20487213134766
RVBD0597c:RVBD0597c,0,0,0,0,0,RV0597c,I6WYU2,92.9076919555664
RVBD2635:RVBD2635,0,0,0,0,0,RV2635,P9WL57,50.40900421142578
RVBD0324:RVBD0324,0,0,0,0,0,RV0324,O08446,93.35199737548828
RVBD2759c:RVBD2759c,0,0,0,0,0,RV2759c,P9WF57,92.84642028808594
RVBD3312A:RVBD3312A,0,0,0,0,0,RV3312A,P9WI87,66.42552947998047
RVBD3209:RVBD3209,0,0,0,0,0,RV3209,O05857,76.80672454833984
RVBD2911:dacB2,0,0,0,0,0,RV2911,I6Y204,93.83899688720703
RVBD1268c:RVBD1268c,0,0,0,0,0,RV1268c,P9WM47,89.40232849121094
RVBD3116:moeB2,0,0,0,0,0,RV3116,L7N674,91.86861419677734
RVBD2884:RVBD2884,0,0,0,0,0,RV2884,I6X5M3,81.02495574951172
RVBD0269c:RVBD0269c,0,0,0,0,0,RV0269c,P95226,94.62198638916016
RVBD1800:PPE28,0,0,0,0,0,RV1800,P9WI11,79.1807632446289
RVBD1498A:RVBD1498A,0,0,0,0,0,RV1498A,I6XY36,94.99386596679688
RVBD1833c:RVBD1833c,0,0,0,0,0,RV1833c,P9WMS1,97.73363494873047
RVBD1256c:cyp130,0,0,0,0,0,RV1256c,P9WPN5,94.69691467285156
RVBD1061:RVBD1061,0,0,0,0,0,RV1061,O53409,89.67156982421875
RVBD0420c:RVBD0420c,0,0,0,0,0,RV0420c,P96266,72.38713836669922
RVBD3254:RVBD3254,0,0,0,0,0,RV3254,O05897,88.49647521972656
RVBD0941c:RVBD0941c,0,0,0,0,0,RV0941c,P71568,91.34817504882812
RVBD0802c:RVBD0802c,0,0,0,0,0,RV0802c,P9WQG7,95.98806762695312
RVBD3429:PPE59,0,0,0,0,0,RV3429,P9WHY1,93.83663940429688
RVBD3398c:idsA1,0,0,0,0,0,RV3398c,P9WKH1,90.42559814453125
RVBD0132c:fgd2,0,0,0,0,0,RV0132c,P96809,90.48383331298828
RVBD2323c:RVBD2323c,0,0,0,0,0,RV2323c,P71889,92.61079406738281
RVBD3063:cstA,0,0,0,0,0,RV3063,P9WP47,89.98674774169922
RVBD2999:lppY,0,0,0,0,0,RV2999,O53246,90.84062194824219
RVBD1039c:PPE15,0,0,0,0,0,RV1039c,P9WI31,70.04503631591797
RVBD1413:RVBD1413,0,0,0,0,0,RV1413,P9WLY5,90.77449798583984
RVBD3675:RVBD3675,0,0,0,0,0,RV3675,I6YCQ7,68.40311431884766
RVBD3085:RVBD3085,0,0,0,0,0,RV3085,P9WGP9,93.43437957763672
RVBD1940:ribA1,0,0,0,0,0,RV1940,L7N669,88.60753631591797
RVBD2772c:RVBD2772c,0,0,0,0,0,RV2772c,I6YA75,81.82305908203125
RVBD3759c:proX,0,0,0,0,0,RV3759c,O69725,91.48774719238281
RVBD6029:tRNA-Gly27,0,0,0,0,0,RV6029,,
RVBD3376:RVBD3376,0,0,0,0,0,RV3376,P9WMS5,89.77912902832031
RVBD3516:echA19,0,0,0,0,0,RV3516,O53561,94.87969207763672
RVBD2933:ppsC,0,0,0,0,0,RV2933,P96202,85.3028335571289
RVBD2643A:RVBD2643A,0,0,0,0,0,RV2643A,,
RVBD1919c:RVBD1919c,0,0,0,0,0,RV1919c,O53961,95.2148666381836
RVBD1543:RVBD1543,0,0,0,0,0,RV1543,P9WGS1,88.10096740722656
RVBD1522c:mmpL12,0,0,0,0,0,RV1522c,P9WJT7,76.54623413085938
RVBD2446c:RVBD2446c,0,0,0,0,0,RV2446c,O53173,88.578125
RVBD2575:RVBD2575,0,0,0,0,0,RV2575,P9WL85,84.18494415283203
RVBD0549c:RVBD0549c,0,0,0,0,0,RV0549c,P9WFB7,94.35993194580078
RVBD3136:PPE51,0,0,0,0,0,RV3136,P9WHY3,67.79549407958984
RVBD1819c:bacA,0,0,0,0,0,RV1819c,P9WQI9,94.03430938720703
RVBD0851c:RVBD0851c,0,0,0,0,0,RV0851c,O53863,92.07344818115234
RVBD1119c:RVBD1119c,0,0,0,0,0,RV1119c,O06571,73.2818374633789
RVBD2651c:RVBD2651c,0,0,0,0,0,RV2651c,I6XEX3,88.70514678955078
RVBD2862A:vapB23,0,0,0,0,0,RV2862A,P0CW32,90.34256744384766
RVBD0559c:RVBD0559c,0,0,0,0,0,RV0559c,P9WKL3,89.19224548339844
RVBD1233c:RVBD1233c,0,0,0,0,0,RV1233c,O86316,57.29059982299805
RVBD2288:RVBD2288,0,0,0,0,0,RV2288,P9WLE5,32.46432113647461
RVBD1237:sugB,0,0,0,0,0,RV1237,P9WG01,91.5689468383789
RVBD2119:RVBD2119,0,0,0,0,0,RV2119,O33254,90.8361587524414
RVBD2408:PE24,0,0,0,0,0,RV2408,Q79FE3,60.600589752197266
RVBD2641:cadI,0,0,0,0,0,RV2641,P9WIR5,86.20584869384766
RVBD3857c:RVBD3857c,0,0,0,0,0,RV3857c,P96220,88.34153747558594
RVBD2885c:RVBD2885c,0,0,0,0,0,RV2885c,P9WL37,86.85199737548828
RVBD1113:vapB32,0,0,0,0,0,RV1113,P9WJ33,93.65015411376953
RVBD1941:RVBD1941,0,0,0,0,0,RV1941,I6XZC4,96.57882690429688
RVBD2505c:fadD35,0,0,0,0,0,RV2505c,I6Y0X0,92.46871948242188
RVBD3417c:groEL1,0,0,0,0,0,RV3417c,P9WPE9,92.73356628417969
RVBD0758:phoR,0,0,0,0,0,RV0758,P71815,86.16873931884766
RVBD0025:RVBD0025,0,0,0,0,0,RV0025,P9WMA1,91.10657501220703
RVBD2160A:RVBD2160A,0,0,0,0,0,RV2160A,L0TBP1,70.85275268554688
RVBD3055:RVBD3055,0,0,0,0,0,RV3055,P95103,89.5987777709961
RVBD1374c:RVBD1374c,0,0,0,0,0,RV1374c,P71802,36.14895248413086
RVBD2698:RVBD2698,0,0,0,0,0,RV2698,I6X552,84.69229888916016
RVBD2305:RVBD2305,0,0,0,0,0,RV2305,P9WLD1,86.17251586914062
RVBD3083:RVBD3083,0,0,0,0,0,RV3083,P9WNF7,93.16456604003906
RVBD2293c:RVBD2293c,0,0,0,0,0,RV2293c,P9WLE1,80.32662963867188
RVBD2437:RVBD2437,0,0,0,0,0,RV2437,P71912,87.89144134521484
RVBD3763:lpqH,0,0,0,0,0,RV3763,P9WK61,81.4296875
RVBD0613c:RVBD0613c,0,0,0,0,0,RV0613c,I6Y897,88.67293548583984
RVBD1952:vapB14,0,0,0,0,0,RV1952,P95262,90.39324188232422
RVBD1179c:RVBD1179c,0,0,0,0,0,RV1179c,O50435,84.25292205810547
RVBD0564c:gpdA1,0,0,0,0,0,RV0564c,P9WN75,92.62114715576172
RVBD0320:RVBD0320,0,0,0,0,0,RV0320,O07246,79.74568176269531
RVBD1454c:qor,0,0,0,0,0,RV1454c,O53146,97.42984771728516
RVBD0921:RVBD0921,0,0,0,0,0,RV0921,I6WZS4,91.18231964111328
RVBD2779c:RVBD2779c,0,0,0,0,0,RV2779c,O33321,83.3203353881836
RVBD2765:RVBD2765,0,0,0,0,0,RV2765,I6XF92,97.40347290039062
RVBD3304:RVBD3304,0,0,0,0,0,RV3304,O53356,91.0433349609375
RVBD0836c:RVBD0836c,0,0,0,0,0,RV0836c,O53848,90.8353042602539
RVBD2265:RVBD2265,0,0,0,0,0,RV2265,P9WLG3,89.47554779052734
RVBD0293c:RVBD0293c,0,0,0,0,0,RV0293c,O53697,88.11712646484375
RVBD3905c:esxF,0,0,0,0,0,RV3905c,P9WNH7,91.40203094482422
RVBD0159c:PE3,0,0,0,0,0,RV0159c,Q79G04,89.75379943847656
RVBD1905c:aao,0,0,0,0,0,RV1905c,P9WP27,94.16436767578125
RVBD3308:pmmB,0,0,0,0,0,RV3308,O53360,95.75395202636719
RVBD0160c:PE4,0,0,0,0,0,RV0160c,L7N661,87.5971450805664
RVBD3371:RVBD3371,0,0,0,0,0,RV3371,P9WKA9,70.28529357910156
RVBD0762c:RVBD0762c,0,0,0,0,0,RV0762c,I6XW93,94.36419677734375
RVBD3114:RVBD3114,0,0,0,0,0,RV3114,O05791,88.23119354248047
RVBD1675c:cmr,0,0,0,0,0,RV1675c,P9WMH5,90.82425689697266
RVBD1580c:RVBD1580c,0,0,0,0,0,RV1580c,O06610,48.823219299316406
RVBD3121:cyp141,0,0,0,0,0,RV3121,P9WPL7,91.78302764892578
RVBD2249c:glpD1,0,0,0,0,0,RV2249c,P9WN81,93.36968231201172
RVBD3527:RVBD3527,0,0,0,0,0,RV3527,I6XHG6,81.64180755615234
RVBD2873:mpt83,0,0,0,0,0,RV2873,P9WNF3,81.79073333740234
RVBD2443:dctA,0,0,0,0,0,RV2443,P71906,77.8221435546875
RVBD1930c:RVBD1930c,0,0,0,0,0,RV1930c,P95284,76.41632080078125
RVBD2079:RVBD2079,0,0,0,0,0,RV2079,P9WLK7,84.78931427001953
RVBD1251c:RVBD1251c,0,0,0,0,0,RV1251c,O50466,89.62918853759766
RVBD2686c:RVBD2686c,0,0,0,0,0,RV2686c,P9WJB3,85.9368667602539
RVBD0773c:ggtA,0,0,0,0,0,RV0773c,I6X9S5,95.62931823730469
RVBD0630c:recB,0,0,0,0,0,RV0630c,P9WMQ3,89.5486068725586
RVBD2129c:RVBD2129c,0,0,0,0,0,RV2129c,O33263,95.94644927978516
RVBD3318:sdhA,0,0,0,0,0,RV3318,O53370,96.20006561279297
RVBD3505:fadE27,0,0,0,0,0,RV3505,I6Y3Q0,94.60411071777344
RVBD3087:RVBD3087,0,0,0,0,0,RV3087,P9WKB1,89.4883804321289
RVBD2646:RVBD2646,0,0,0,0,0,RV2646,I6XEU5,89.92268371582031
RVBD3406:RVBD3406,0,0,0,0,0,RV3406,P9WKZ1,92.25206756591797
RVBD1267c:embR,0,0,0,0,0,RV1267c,P9WGJ9,91.84048461914062
RVBD0243:fadA2,0,0,0,0,0,RV0243,O86361,95.22538757324219
RVBD0078A:RVBD0078A,0,0,0,0,0,RV0078A,L7N686,92.73882293701172
RVBD2557:RVBD2557,0,0,0,0,0,RV2557,P9WLA5,92.15630340576172
RVBD0791c:RVBD0791c,0,0,0,0,0,RV0791c,I6X9T8,90.78458404541016
RVBD2793c:truB,0,0,0,0,0,RV2793c,P9WHP7,93.1886215209961
RVBD0616c:RVBD0616c,0,0,0,0,0,RV0616c,O07761,61.97966003417969
RVBD3109:moaA1,0,0,0,0,0,RV3109,P9WJS3,93.99665832519531
RVBD1341:RVBD1341,0,0,0,0,0,RV1341,P9WMR7,94.80010223388672
RVBD2143:RVBD2143,0,0,0,0,0,RV2143,O06232,78.38201904296875
RVBD0697:RVBD0697,0,0,0,0,0,RV0697,I6Y8H4,94.9314956665039
RVBD2276:cyp121,0,0,0,0,0,RV2276,P9WPP7,95.44295501708984
RVBD2329c:narK1,0,0,0,0,0,RV2329c,P71883,84.18974304199219
RVBD3519:RVBD3519,0,0,0,0,0,RV3519,O53564,96.05792236328125
RVBD2750:RVBD2750,0,0,0,0,0,RV2750,P9WGS5,95.05609893798828
RVBD0329c:RVBD0329c,0,0,0,0,0,RV0329c,O07253,94.08773803710938
RVBD3517:RVBD3517,0,0,0,0,0,RV3517,O53562,93.7913589477539
RVBD3062:ligB,0,0,0,0,0,RV3062,P9WNV5,92.92942810058594
RVBD1213:glgC,0,0,0,0,0,RV1213,P9WN43,93.7413101196289
RVBD2327:RVBD2327,0,0,0,0,0,RV2327,P71885,87.44017791748047
RVBD1746:pknF,0,0,0,0,0,RV1746,P9WI75,80.96768188476562
RVBD2985:mutT1,0,0,0,0,0,RV2985,P9WIY3,92.55113983154297
RVBD0783c:emrB,0,0,0,0,0,RV0783c,P9WG89,80.96063232421875
RVBD1123c:bpoB,0,0,0,0,0,RV1123c,O06575,87.03360748291016
RVBD2274c:mazF8,0,0,0,0,0,RV2274c,P9WIH7,42.12818908691406
RVBD2376c:cfp2,0,0,0,0,0,RV2376c,P9WIN7,64.62565612792969
RVBD2331:RVBD2331,0,0,0,0,0,RV2331,P9WLB3,48.28414535522461
RVBD0273c:RVBD0273c,0,0,0,0,0,RV0273c,O86342,92.56307220458984
RVBD0256c:PPE2,0,0,0,0,0,RV0256c,P9WI47,67.0352554321289
RVBD2332:mez,0,0,0,0,0,RV2332,P9WK25,95.4787826538086
RVBD0179c:lprO,0,0,0,0,0,RV0179c,O07423,88.93994903564453
RVBD0435c:RVBD0435c,0,0,0,0,0,RV0435c,P96281,82.56672668457031
RVBD3124:moaR1,0,0,0,0,0,RV3124,O05797,84.82626342773438
RVBD0295c:RVBD0295c,0,0,0,0,0,RV0295c,O53699,94.21857452392578
RVBD0373c:RVBD0373c,0,0,0,0,0,RV0373c,O53708,95.98725128173828
RVBD1955:higB,0,0,0,0,0,RV1955,P9WJA5,79.4770278930664
RVBD1985c:RVBD1985c,0,0,0,0,0,RV1985c,P9WMF5,89.80775451660156
RVBD2133c:RVBD2133c,0,0,0,0,0,RV2133c,O06242,95.07072448730469
RVBD0234c:gabD1,0,0,0,0,0,RV0234c,P9WNX9,98.28582000732422
RVBD0767c:RVBD0767c,0,0,0,0,0,RV0767c,P9WMD7,85.18948364257812
RVBD3321c:vapB44,0,0,0,0,0,RV3321c,P9WJ17,84.578125
RVBD1579c:RVBD1579c,0,0,0,0,0,RV1579c,O06611,85.45067596435547
RVBD0235c:RVBD0235c,0,0,0,0,0,RV0235c,P96418,95.4809341430664
RVBD1881c:lppE,0,0,0,0,0,RV1881c,O07750,88.81828308105469
RVBD3876:espI,0,0,0,0,0,RV3876,P9WJC5,64.93106079101562
RVBD2040c:RVBD2040c,0,0,0,0,0,RV2040c,O53484,90.3413314819336
RVBD1016c:lpqT,0,0,0,0,0,RV1016c,P9WK59,83.50933074951172
RVBD0118c:oxcA,0,0,0,0,0,RV0118c,O53639,94.84247589111328
RVBD2316:uspA,0,0,0,0,0,RV2316,P71896,90.38961791992188
RVBD2394:ggtB,0,0,0,0,0,RV2394,P71750,90.79076385498047
RVBD2817c:RVBD2817c,0,0,0,0,0,RV2817c,P9WPJ5,89.28150939941406
RVBD1899c:lppD,0,0,0,0,0,RV1899c,P9WK29,65.36158752441406
RVBD2702:ppgK,0,0,0,0,0,RV2702,P9WIN1,92.6213607788086
RVBD0457c:RVBD0457c,0,0,0,0,0,RV0457c,O07178,95.55561828613281
RVBD0424c:RVBD0424c,0,0,0,0,0,RV0424c,P96270,63.76154327392578
RVBD2643:arsC,0,0,0,0,0,RV2643,I6X4W4,83.68803405761719
RVBD2113:RVBD2113,0,0,0,0,0,RV2113,O33248,80.7506332397461
RVBD1608c:bcpB,0,0,0,0,0,RV1608c,P9WID9,95.78467559814453
RVBD3127:RVBD3127,0,0,0,0,0,RV3127,P9WL07,91.84616088867188
RVBD2780:ald,0,0,0,0,0,RV2780,P9WQB1,96.35894012451172
RVBD2803:RVBD2803,0,0,0,0,0,RV2803,I6XFC2,70.81986999511719
RVBD0141c:RVBD0141c,0,0,0,0,0,RV0141c,P96818,93.03103637695312
RVBD0503c:cmaA2,0,0,0,0,0,RV0503c,P9WPB5,95.80780792236328
RVBD3263:RVBD3263,0,0,0,0,0,RV3263,P96868,89.00543975830078
RVBD2387:RVBD2387,0,0,0,0,0,RV2387,P71757,83.41678619384766
RVBD2874:dipZ,0,0,0,0,0,RV2874,P9WG63,73.52375030517578
RVBD1995:RVBD1995,0,0,0,0,0,RV1995,P9WLP3,85.11376190185547
RVBD0492A:RVBD0492A,0,0,0,0,0,RV0492A,Q6MX36,87.70203399658203
RVBD0464c:RVBD0464c,0,0,0,0,0,RV0464c,O53749,92.49473571777344
RVBD2665:RVBD2665,0,0,0,0,0,RV2665,I6Y1F9,78.16204071044922
RVBD1424c:RVBD1424c,0,0,0,0,0,RV1424c,P9WLX7,32.41039276123047
RVBD1948c:RVBD1948c,0,0,0,0,0,RV1948c,P95266,95.65387725830078
RVBD3338:RVBD3338,0,0,0,0,0,RV3338,O53388,87.72257232666016
RVBD1721c:vapB12,0,0,0,0,0,RV1721c,P9WJ53,93.21920013427734
RVBD1377c:RVBD1377c,0,0,0,0,0,RV1377c,P71805,94.30707550048828
RVBD0348:RVBD0348,0,0,0,0,0,RV0348,O06299,83.91832733154297
RVBD0830:RVBD0830,0,0,0,0,0,RV0830,P9WFI3,92.12580871582031
RVBD1992c:ctpG,0,0,0,0,0,RV1992c,P9WPS7,82.92549896240234
RVBD1891:RVBD1891,0,0,0,0,0,RV1891,O07741,85.19851684570312
RVBD2458:mmuM,0,0,0,0,0,RV2458,O53185,93.77738189697266
RVBD3890c:esxC,0,0,0,0,0,RV3890c,P9WNI1,90.78285217285156
RVBD0897c:RVBD0897c,0,0,0,0,0,RV0897c,P9WKP7,95.92121887207031
RVBD1983:PE-PGRS35,0,0,0,0,0,RV1983,P9WIF1,93.1815414428711
RVBD1141c:echA11,0,0,0,0,0,RV1141c,O06541,95.81668090820312
RVBD1498c:RVBD1498c,0,0,0,0,0,RV1498c,P9WLW9,90.68193817138672
RVBD0726c:RVBD0726c,0,0,0,0,0,RV0726c,P9WFI7,81.02850341796875
RVBD2600:RVBD2600,0,0,0,0,0,RV2600,P9WFG5,89.99519348144531
RVBD1877:RVBD1877,0,0,0,0,0,RV1877,P9WG85,77.9019546508789
RVBD0594:mce2F,0,0,0,0,0,RV0594,O07784,80.5934829711914
RVBD0008c:RVBD0008c,0,0,0,0,0,RV0008c,P9WJF3,67.03834533691406
RVBD2063A:mazF7,0,0,0,0,0,RV2063A,P0CL62,85.69866943359375
RVBD3295:RVBD3295,0,0,0,0,0,RV3295,P96900,87.89317321777344
RVBD2529:RVBD2529,0,0,0,0,0,RV2529,P95024,75.55474090576172
RVBD1873:RVBD1873,0,0,0,0,0,RV1873,O07756,96.88123321533203
RVBD0973c:accA2,0,0,0,0,0,RV0973c,P71538,91.91532897949219
RVBD1103c:mazE3,0,0,0,0,0,RV1103c,O53451,74.13641357421875
RVBD0792c:RVBD0792c,0,0,0,0,0,RV0792c,O86331,86.02420043945312
RVBD2280:RVBD2280,0,0,0,0,0,RV2280,P9WIT1,95.40623474121094
RVBD3739c:PPE67,0,0,0,0,0,RV3739c,Q79FA2,96.50492858886719
RVBD2963:RVBD2963,0,0,0,0,0,RV2963,I6YET7,83.74591064453125
RVBD3477:PE31,0,0,0,0,0,RV3477,I6YG87,91.46092987060547
RVBD3319:sdhB,0,0,0,0,0,RV3319,O53371,93.74581909179688
RVBD1900c:lipJ,0,0,0,0,0,RV1900c,O07732,89.22216796875
RVBD1933c:fadE18,0,0,0,0,0,RV1933c,P95281,93.58790588378906
RVBD1028c:kdpD,0,0,0,0,0,RV1028c,P9WGL3,81.38932800292969
RVBD1490:RVBD1490,0,0,0,0,0,RV1490,P9WLX1,90.87384033203125
RVBD1918c:PPE35,0,0,0,0,0,RV1918c,Q79FI8,71.61613464355469
RVBD1526c:RVBD1526c,0,0,0,0,0,RV1526c,P9WLV1,89.49568176269531
RVBD3738c:PPE66,0,0,0,0,0,RV3738c,P9WHX1,73.92212677001953
RVBD2762c:RVBD2762c,0,0,0,0,0,RV2762c,I6X5B0,59.38151168823242
RVBD3174:RVBD3174,0,0,0,0,0,RV3174,O53324,96.53549194335938
RVBD0493c:RVBD0493c,0,0,0,0,0,RV0493c,P9WKU7,93.14018249511719
RVBD1034c:RVBD1034c,0,0,0,0,0,RV1034c,I6X043,94.00946044921875
RVBD0182c:sigG,0,0,0,0,0,RV0182c,P9WGG5,82.67359924316406
RVBD2281:pitB,0,0,0,0,0,RV2281,P9WIA5,87.37068176269531
RVBD0425c:ctpH,0,0,0,0,0,RV0425c,P96271,76.2183609008789
RVBD1869c:RVBD1869c,0,0,0,0,0,RV1869c,P95146,96.89545440673828
RVBD3667:acs,0,0,0,0,0,RV3667,P9WQD1,91.98248291015625
RVBD3607c:folB,0,0,0,0,0,RV3607c,P9WNC5,86.79315948486328
RVBD1516c:RVBD1516c,0,0,0,0,0,RV1516c,P71795,91.55371856689453
RVBD0465c:RVBD0465c,0,0,0,0,0,RV0465c,P9WMI1,86.13726043701172
RVBD0305c:PPE6,0,0,0,0,0,RV0305c,Q6MX48,79.21988677978516
RVBD3558:PPE64,0,0,0,0,0,RV3558,Q6MWW0,93.864013671875
RVBD2715:RVBD2715,0,0,0,0,0,RV2715,P9WNH3,88.9147720336914
RVBD2679:echA15,0,0,0,0,0,RV2679,I6YA03,95.47586822509766
RVBD2250c:RVBD2250c,0,0,0,0,0,RV2250c,P9WMC5,92.67131805419922
RVBD3562:fadE31,0,0,0,0,0,RV3562,I6YGH7,94.38131713867188
RVBD0753c:mmsA,0,0,0,0,0,RV0753c,O53816,96.88230895996094
RVBD1593c:RVBD1593c,0,0,0,0,0,RV1593c,O06597,90.15507507324219
RVBD1046c:RVBD1046c,0,0,0,0,0,RV1046c,L0T8G6,52.00827407836914
RVBD0905:echA6,0,0,0,0,0,RV0905,P9WNP1,95.30970001220703
RVBD2737A:RVBD2737A,0,0,0,0,0,RV2737A,Q79FB4,87.76123046875
RVBD2296:RVBD2296,0,0,0,0,0,RV2296,P9WMS3,96.69432830810547
RVBD2939:papA5,0,0,0,0,0,RV2939,P9WIN5,88.54369354248047
RVBD0890c:RVBD0890c,0,0,0,0,0,RV0890c,P9WMG1,87.07868957519531
RVBD0779c:RVBD0779c,0,0,0,0,0,RV0779c,P71833,85.10636138916016
RVBD1355c:moeY,0,0,0,0,0,RV1355c,P9WM11,91.76373291015625
RVBD2601A:vapB41,0,0,0,0,0,RV2601A,P9WJ21,85.94252014160156
RVBD0914c:RVBD0914c,0,0,0,0,0,RV0914c,I6XWJ8,96.79425811767578
RVBD1936:RVBD1936,0,0,0,0,0,RV1936,P95278,95.1224365234375
RVBD3768:RVBD3768,0,0,0,0,0,RV3768,P72035,96.79303741455078
RVBD1976c:RVBD1976c,0,0,0,0,0,RV1976c,O53977,92.14755249023438
RVBD3772:hisC2,0,0,0,0,0,RV3772,P9WML5,96.15858459472656
RVBD2388c:hemN,0,0,0,0,0,RV2388c,P9WP73,95.68077087402344
RVBD0575c:RVBD0575c,0,0,0,0,0,RV0575c,O53772,91.28793334960938
RVBD0932c:pstS2,0,0,0,0,0,RV0932c,P9WGT9,91.33140563964844
RVBD1514c:RVBD1514c,0,0,0,0,0,RV1514c,P9WMX9,93.04869842529297
RVBD1468c:PE-PGRS29,0,0,0,0,0,RV1468c,Q79FP0,93.77838134765625
RVBD3727:RVBD3727,0,0,0,0,0,RV3727,O69694,88.42259216308594
RVBD2577:RVBD2577,0,0,0,0,0,RV2577,P9WL81,90.01761627197266
RVBD0971c:echA7,0,0,0,0,0,RV0971c,P71540,94.94743347167969
RVBD1729c:RVBD1729c,0,0,0,0,0,RV1729c,P9WFH9,85.87976837158203
RVBD2589:gabT,0,0,0,0,0,RV2589,P9WQ79,98.00463104248047
RVBD1765A:RVBD1765A,0,0,0,0,0,RV1765A,Q79FL0,71.6942138671875
RVBD2428:ahpC,0,0,0,0,0,RV2428,P9WQB7,93.31707000732422
RVBD0786c:RVBD0786c,0,0,0,0,0,RV0786c,P71839,96.97805786132812
RVBD2932:ppsB,0,0,0,0,0,RV2932,P9WQE5,86.69181060791016
RVBD1725c:RVBD1725c,0,0,0,0,0,RV1725c,P71983,92.74724578857422
RVBD3812:PE-PGRS62,0,0,0,0,0,RV3812,L7N680,69.36202239990234
RVBD1969:mce3D,0,0,0,0,0,RV1969,O53970,84.18182373046875
RVBD0646c:lipG,0,0,0,0,0,RV0646c,P96935,96.23876953125
RVBD0208c:RVBD0208c,0,0,0,0,0,RV0208c,P9WFY9,83.27767944335938
RVBD0355c:PPE8,0,0,0,0,0,RV0355c,I6Y7L4,
RVBD1928c:RVBD1928c,0,0,0,0,0,RV1928c,P95286,97.1586685180664
RVBD3329:RVBD3329,0,0,0,0,0,RV3329,O53379,94.3687515258789
RVBD0760c:RVBD0760c,0,0,0,0,0,RV0760c,I6WZD7,94.65827178955078
RVBD1175c:fadH,0,0,0,0,0,RV1175c,O50431,97.11397552490234
RVBD1724c:RVBD1724c,0,0,0,0,0,RV1724c,P71982,75.08000183105469
RVBD0624:vapC30,0,0,0,0,0,RV0624,P9WF77,96.62488555908203
RVBD1730c:RVBD1730c,0,0,0,0,0,RV1730c,P71988,88.4037094116211
RVBD2618:RVBD2618,0,0,0,0,0,RV2618,O06195,90.45631408691406
RVBD3252c:alkB,0,0,0,0,0,RV3252c,O05895,93.29317474365234
RVBD2075c:RVBD2075c,0,0,0,0,0,RV2075c,P9WLL5,88.8665542602539
RVBD0669c:RVBD0669c,0,0,0,0,0,RV0669c,O06769,96.02098083496094
RVBD1685c:RVBD1685c,0,0,0,0,0,RV1685c,O33187,87.29048156738281
RVBD3873:PPE68,0,0,0,0,0,RV3873,P9WHW9,68.69718170166016
RVBD0596c:RVBD0596c,0,0,0,0,0,RV0596c,P9WF21,91.90811157226562
RVBD1397c:vapC10,0,0,0,0,0,RV1397c,P9WFA7,94.29910278320312
RVBD3369:RVBD3369,0,0,0,0,0,RV3369,O50398,93.54409790039062
RVBD1273c:RVBD1273c,0,0,0,0,0,RV1273c,P9WQJ1,89.68975830078125
RVBD1979c:RVBD1979c,0,0,0,0,0,RV1979c,P9WQM5,87.03841400146484
RVBD2652c:RVBD2652c,0,0,0,0,0,RV2652c,P71949,78.35062408447266
RVBD2659c:RVBD2659c,0,0,0,0,0,RV2659c,P9WMB3,89.55802154541016
RVBD0806c:cpsY,0,0,0,0,0,RV0806c,P9WGD1,89.86558532714844
RVBD1548c:PPE21,0,0,0,0,0,RV1548c,P9WI21,86.8986587524414
RVBD0077c:RVBD0077c,0,0,0,0,0,RV0077c,O53622,97.6002197265625
RVBD3129:RVBD3129,0,0,0,0,0,RV3129,P9WL05,81.05592346191406
RVBD3331:sugI,0,0,0,0,0,RV3331,L0TDU1,82.03294372558594
RVBD3175:RVBD3175,0,0,0,0,0,RV3175,O53325,95.44683074951172
RVBD0870c:RVBD0870c,0,0,0,0,0,RV0870c,I6Y8Z3,94.41666412353516
RVBD2248:RVBD2248,0,0,0,0,0,RV2248,P9WLG5,93.52962493896484
RVBD2642:RVBD2642,0,0,0,0,0,RV2642,P71941,82.79705047607422
RVBD2657c:RVBD2657c,0,0,0,0,0,RV2657c,I6YE30,77.0986099243164
RVBD0913c:RVBD0913c,0,0,0,0,0,RV0913c,I6Y551,96.0096664428711
RVBD3521:RVBD3521,0,0,0,0,0,RV3521,O53566,94.47728729248047
RVBD0178:RVBD0178,0,0,0,0,0,RV0178,O07422,75.37999725341797
RVBD3448:eccD4,0,0,0,0,0,RV3448,P9WNQ1,84.01117706298828
RVBD2473:RVBD2473,0,0,0,0,0,RV2473,O53200,76.5158462524414
RVBD0251c:hsp,0,0,0,0,0,RV0251c,O53673,77.36283111572266
RVBD1912c:fadB5,0,0,0,0,0,RV1912c,O07721,93.35443115234375
RVBD2766c:RVBD2766c,0,0,0,0,0,RV2766c,I6YEB6,95.7376937866211
RVBD1322A:RVBD1322A,0,0,0,0,0,RV1322A,L7N6B1,93.9480972290039
RVBD1755c:plcD,0,0,0,0,0,RV1755c,P9WIA9,88.46114349365234
RVBD2077Bc:RVBD2077Bc,0,0,0,0,0,RV2077Bc,,
RVBD0844c:narL,0,0,0,0,0,RV0844c,P9WGM5,93.08689880371094
RVBD2423:RVBD2423,0,0,0,0,0,RV2423,P71925,95.30940246582031
RVBD1266c:pknH,0,0,0,0,0,RV1266c,P9WI71,81.48819732666016
RVBD1750c:fadD1,0,0,0,0,0,RV1750c,P72007,92.56607055664062
RVBD1896c:RVBD1896c,0,0,0,0,0,RV1896c,P9WFH7,90.10122680664062
RVBD1844c:gnd1,0,0,0,0,0,RV1844c,Q79FJ2,95.52816009521484
RVBD2631:RVBD2631,0,0,0,0,0,RV2631,P9WGW5,96.45321655273438
RVBD2928:tesA,0,0,0,0,0,RV2928,P9WQD5,83.9057846069336
RVBD3526:kshA,0,0,0,0,0,RV3526,P71875,92.9690933227539
RVBD1528c:papA4,0,0,0,0,0,RV1528c,O53902,44.4460563659668
RVBD3385c:RVBD3385c,0,0,0,0,0,RV3385c,P9WF13,88.23177337646484
RVBD3594:RVBD3594,0,0,0,0,0,RV3594,I6Y3Z2,92.66414642333984
RVBD3524:RVBD3524,0,0,0,0,0,RV3524,I6X7J6,81.10932922363281
RVBD3731:ligC,0,0,0,0,0,RV3731,L0TDE1,88.84049987792969
RVBD0107c:ctpI,0,0,0,0,0,RV0107c,P9WPS5,74.0387191772461
RVBD1926c:mpt63,0,0,0,0,0,RV1926c,P9WIP1,87.44918060302734
RVBD0275c:RVBD0275c,0,0,0,0,0,RV0275c,L7N6A2,82.87659454345703
RVBD2059:RVBD2059,0,0,0,0,0,RV2059,O07257,60.048805236816406
RVBD0044c:RVBD0044c,0,0,0,0,0,RV0044c,P71701,95.26602172851562
RVBD3122:RVBD3122,0,0,0,0,0,RV3122,O07033,83.15384674072266
RVBD2012:RVBD2012,0,0,0,0,0,RV2012,P9WLM3,87.87061309814453
RVBD0492c:RVBD0492c,0,0,0,0,0,RV0492c,P9WMV7,94.60200500488281
RVBD0546c:RVBD0546c,0,0,0,0,0,RV0546c,O06412,94.14656066894531
RVBD0300:RVBD0300,0,0,0,0,0,RV0300,O07227,93.4706802368164
RVBD1639c:RVBD1639c,0,0,0,0,0,RV1639c,P94973,88.6014633178711
RVBD3317:sdhD,0,0,0,0,0,RV3317,O53369,96.15576171875
RVBD3113:RVBD3113,0,0,0,0,0,RV3113,O05790,93.1834716796875
RVBD0230c:php,0,0,0,0,0,RV0230c,P9WHN9,97.46282196044922
RVBD1542c:glbN,0,0,0,0,0,RV1542c,P9WN25,91.71161651611328
RVBD1507A:RVBD1507A,0,0,0,0,0,RV1507A,L7N6B6,37.51311492919922
RVBD2088:pknJ,0,0,0,0,0,RV2088,P9WI67,79.71629333496094
RVBD1975:RVBD1975,0,0,0,0,0,RV1975,O53976,74.05701446533203
RVBD2960c:RVBD2960c,0,0,0,0,0,RV2960c,P95133,44.57328796386719
RVBD1515c:RVBD1515c,0,0,0,0,0,RV1515c,P71794,90.28194427490234
RVBD1272c:RVBD1272c,0,0,0,0,0,RV1272c,P9WQJ3,88.4034423828125
RVBD3196:RVBD3196,0,0,0,0,0,RV3196,O53342,87.70873260498047
RVBD2998:RVBD2998,0,0,0,0,0,RV2998,O53245,34.674312591552734
RVBD0131c:fadE1,0,0,0,0,0,RV0131c,P96808,93.2724838256836
RVBD3872:PE35,0,0,0,0,0,RV3872,P9WIG7,90.83210754394531
RVBD3297:nei,0,0,0,0,0,RV3297,P9WNC1,95.92310333251953
RVBD2292c:RVBD2292c,0,0,0,0,0,RV2292c,P9WLE3,93.40689849853516
RVBD1357c:RVBD1357c,0,0,0,0,0,RV1357c,P9WM07,80.64704132080078
RVBD0931c:pknD,0,0,0,0,0,RV0931c,P9WI79,80.214111328125
RVBD1923:lipD,0,0,0,0,0,RV1923,P95290,88.17436981201172
RVBD3532:PPE61,0,0,0,0,0,RV3532,P9WHX9,67.89563751220703
RVBD1739c:RVBD1739c,0,0,0,0,0,RV1739c,P9WGF7,92.72662353515625
RVBD3504:fadE26,0,0,0,0,0,RV3504,I6YCA3,91.91368865966797
RVBD2749:RVBD2749,0,0,0,0,0,RV2749,O33291,96.39163970947266
RVBD0645c:mmaA1,0,0,0,0,0,RV0645c,P9WPB1,96.6737060546875
RVBD0813c:RVBD0813c,0,0,0,0,0,RV0813c,P9WFG9,90.98800659179688
RVBD2807:RVBD2807,0,0,0,0,0,RV2807,P71644,84.39468383789062
RVBD3777:RVBD3777,0,0,0,0,0,RV3777,P72043,97.08719635009766
RVBD1835c:RVBD1835c,0,0,0,0,0,RV1835c,P9WIQ9,93.78834533691406
RVBD1879:RVBD1879,0,0,0,0,0,RV1879,O07751,95.70429229736328
RVBD1184c:RVBD1184c,0,0,0,0,0,RV1184c,O50440,85.43746948242188
RVBD1497:lipL,0,0,0,0,0,RV1497,P71778,86.00163269042969
RVBD0105c:rpmB1,0,0,0,0,0,RV0105c,P9WHB1,79.40031433105469
RVBD1446c:opcA,0,0,0,0,0,RV1446c,O06813,94.45195007324219
RVBD3098B:RVBD3098B,0,0,0,0,0,RV3098B,V5QPS4,91.69620513916016
RVBD0878c:PPE13,0,0,0,0,0,RV0878c,P9WI35,80.40869140625
RVBD0725c:RVBD0725c,0,0,0,0,0,RV0725c,P95073,67.82501983642578
RVBD2308:RVBD2308,0,0,0,0,0,RV2308,P9WLC5,79.85697937011719
RVBD1880c:cyp140,0,0,0,0,0,RV1880c,P9WPL9,93.62730407714844
RVBD0976c:RVBD0976c,0,0,0,0,0,RV0976c,O86320,96.6027603149414
RVBD2294:RVBD2294,0,0,0,0,0,RV2294,P9WQ83,95.4170150756836
RVBD0756c:RVBD0756c,0,0,0,0,0,RV0756c,P71813,75.72216033935547
RVBD2991:RVBD2991,0,0,0,0,0,RV2991,O53240,96.22435760498047
RVBD1318c:RVBD1318c,0,0,0,0,0,RV1318c,P9WQ33,86.43433380126953
RVBD1922:RVBD1922,0,0,0,0,0,RV1922,P95291,90.727783203125
RVBD2704:RVBD2704,0,0,0,0,0,RV2704,I6YA21,90.643310546875
RVBD2544:lppB,0,0,0,0,0,RV2544,P9WK79,83.46349334716797
RVBD3367:PE-PGRS51,0,0,0,0,0,RV3367,L0TCB8,94.90547943115234
RVBD0496:RVBD0496,0,0,0,0,0,RV0496,P9WHV5,90.72930145263672
RVBD1901:cinA,0,0,0,0,0,RV1901,P9WPE3,94.56741333007812
RVBD1506c:RVBD1506c,0,0,0,0,0,RV1506c,P71785,95.36325073242188
RVBD2936:drrA,0,0,0,0,0,RV2936,P9WQL9,88.76891326904297
RVBD2102:RVBD2102,0,0,0,0,0,RV2102,O53500,86.46833038330078
RVBD2006:otsB1,0,0,0,0,0,RV2006,P9WN15,89.05841064453125
RVBD0048c:RVBD0048c,0,0,0,0,0,RV0048c,P9WM87,81.41495513916016
RVBD3081:RVBD3081,0,0,0,0,0,RV3081,O53298,74.89060974121094
RVBD0764c:cyp51,0,0,0,0,0,RV0764c,P9WPP9,93.03620147705078
RVBD1283c:oppB,0,0,0,0,0,RV1283c,P9WFZ7,89.88861846923828
RVBD1447c:zwf2,0,0,0,0,0,RV1447c,P9WN73,90.73262786865234
RVBD1987:RVBD1987,0,0,0,0,0,RV1987,P9WLQ1,86.0236587524414
RVBD0398c:RVBD0398c,0,0,0,0,0,RV0398c,P95206,77.82300567626953
RVBD1766:RVBD1766,0,0,0,0,0,RV1766,O06799,89.57168579101562
RVBD2001:RVBD2001,0,0,0,0,0,RV2001,P9WLN5,94.79331970214844
RVBD1991c:mazF6,0,0,0,0,0,RV1991c,P9WII3,97.18184661865234
RVBD3736:RVBD3736,0,0,0,0,0,RV3736,O69703,87.21088409423828
RVBD1688:mpg,0,0,0,0,0,RV1688,P9WJP7,96.96443939208984
RVBD2519:PE26,0,0,0,0,0,RV2519,Q79FD3,92.68296813964844
RVBD0829:RVBD0829,0,0,0,0,0,RV0829,O53840,73.15676879882812
RVBD0689c:RVBD0689c,0,0,0,0,0,RV0689c,I6WZ39,52.02737808227539
RVBD2769c:PE27,0,0,0,0,0,RV2769c,Q79FA8,64.39461517333984
RVBD0576:RVBD0576,0,0,0,0,0,RV0576,O53773,91.25481414794922
RVBD1811:mgtC,0,0,0,0,0,RV1811,I6YBN6,86.19598388671875
RVBD2422:RVBD2422,0,0,0,0,0,RV2422,P71926,79.25111389160156
RVBD2560:RVBD2560,0,0,0,0,0,RV2560,P9WLA1,83.18720245361328
RVBD2348c:RVBD2348c,0,0,0,0,0,RV2348c,P95244,65.51592254638672
RVBD2526:RVBD2526,0,0,0,0,0,RV2526,P9WJ49,91.23480224609375
RVBD2384:mbtA,0,0,0,0,0,RV2384,P71716,89.34700775146484
RVBD1398c:vapB10,0,0,0,0,0,RV1398c,P9WLZ1,87.79317474365234
RVBD1895:RVBD1895,0,0,0,0,0,RV1895,O07737,89.8719253540039
RVBD1964:yrbE3A,0,0,0,0,0,RV1964,O53965,86.00804138183594
RVBD1242:RVBD1242,0,0,0,0,0,RV1242,P9WF69,95.93894958496094
RVBD3372A:RVBD3372A,0,0,0,0,0,RV3372A,,
RVBD1949c:RVBD1949c,0,0,0,0,0,RV1949c,L0T9Q6,81.56586456298828
RVBD2453c:mobA,0,0,0,0,0,RV2453c,P9WJQ9,88.30354309082031
RVBD3408:vapC47,0,0,0,0,0,RV3408,P9WF49,97.37676239013672
RVBD2614A:RVBD2614A,0,0,0,0,0,RV2614A,Q79FC4,48.35613250732422
RVBD3837c:RVBD3837c,0,0,0,0,0,RV3837c,P96241,91.15711212158203
RVBD1144:RVBD1144,0,0,0,0,0,RV1144,P9WGQ7,96.94599914550781
RVBD2283:RVBD2283,0,0,0,0,0,RV2283,P9WLE9,52.008750915527344
RVBD2232:ptkA,0,0,0,0,0,RV2232,P9WPI9,80.02584075927734
RVBD1571:RVBD1571,0,0,0,0,0,RV1571,O06619,96.81893157958984
RVBD2549c:vapC20,0,0,0,0,0,RV2549c,P95004,97.39924621582031
RVBD3841:bfrB,0,0,0,0,0,RV3841,P9WNE5,95.09237670898438
RVBD2010:vapC15,0,0,0,0,0,RV2010,P9WF97,96.15440368652344
RVBD2077A:RVBD2077A,0,0,0,0,0,RV2077A,L7N6B8,78.0180892944336
RVBD1452c:PE-PGRS28,0,0,0,0,0,RV1452c,Q79FP1,81.6551513671875
RVBD1990A:RVBD1990A,0,0,0,0,0,RV1990A,L7N6A3,44.20927810668945
RVBD1945:RVBD1945,0,0,0,0,0,RV1945,P9WLQ5,90.31008911132812
RVBD0711:atsA,0,0,0,0,0,RV0711,P95059,94.36503601074219
RVBD2029c:pfkB,0,0,0,0,0,RV2029c,P9WID3,91.51121520996094
RVBD0980c:PE-PGRS18,0,0,0,0,0,RV0980c,Q79FU0,89.68358612060547
RVBD1162:narH,0,0,0,0,0,RV1162,O06560,85.19094848632812
RVBD1853:ureD,0,0,0,0,0,RV1853,P95161,96.49581146240234
RVBD1974:RVBD1974,0,0,0,0,0,RV1974,O53975,85.95655822753906
RVBD0609A:RVBD0609A,0,0,0,0,0,RV0609A,Q79FY5,53.53466796875
RVBD0471c:RVBD0471c,0,0,0,0,0,RV0471c,O53756,74.29364013671875
RVBD3724B:cut5b,0,0,0,0,0,RV3724B,Q79FA4,89.16502380371094
RVBD3904c:esxE,0,0,0,0,0,RV3904c,P9WNH9,86.44889068603516
RVBD0765c:RVBD0765c,0,0,0,0,0,RV0765c,I6WZD9,92.22624969482422
RVBD2330c:lppP,0,0,0,0,0,RV2330c,P9WK69,88.61165618896484
RVBD1904:RVBD1904,0,0,0,0,0,RV1904,O07728,86.21846008300781
RVBD3770A:RVBD3770A,0,0,0,0,0,RV3770A,L7N6A0,69.81433868408203
RVBD1195:PE13,0,0,0,0,0,RV1195,Q79FR3,95.78453826904297
RVBD0571c:RVBD0571c,0,0,0,0,0,RV0571c,P9WHK1,89.89044952392578
RVBD0590:mce2B,0,0,0,0,0,RV0590,O07788,85.11552429199219
RVBD3757c:proW,0,0,0,0,0,RV3757c,O69723,90.42475891113281
RVBD0857:RVBD0857,0,0,0,0,0,RV0857,I6Y4Z9,94.53547668457031
RVBD1116:RVBD1116,0,0,0,0,0,RV1116,O06568,75.39787292480469
RVBD0616A:RVBD0616A,0,0,0,0,0,RV0616A,P9WJ37,86.14119720458984
RVBD3224A:RVBD3224A,0,0,0,0,0,RV3224A,Q6MWZ5,68.3151626586914
RVBD0438c:moeA2,0,0,0,0,0,RV0438c,P9WJQ5,94.12382507324219
RVBD0649:fabD2,0,0,0,0,0,RV0649,Q79FX5,87.78044891357422
RVBD3173c:RVBD3173c,0,0,0,0,0,RV3173c,O53323,88.36729431152344
RVBD1893:RVBD1893,0,0,0,0,0,RV1893,O07739,69.95249938964844
RVBD1049:RVBD1049,0,0,0,0,0,RV1049,I6Y5H3,90.04898834228516
RVBD0478:deoC,0,0,0,0,0,RV0478,P9WP03,97.53179168701172
RVBD1726:RVBD1726,0,0,0,0,0,RV1726,P71984,95.15709686279297
RVBD2372c:RVBD2372c,0,0,0,0,0,RV2372c,P9WGX1,89.6812515258789
RVBD1705c:PPE22,0,0,0,0,0,RV1705c,P9WI19,73.44808197021484
RVBD2930:fadD26,0,0,0,0,0,RV2930,P9WQ43,90.09654998779297
RVBD3497c:mce4C,0,0,0,0,0,RV3497c,I6YGB1,77.97307586669922
RVBD0148:RVBD0148,0,0,0,0,0,RV0148,P96825,95.28716278076172
RVBD1159A:RVBD1159A,0,0,0,0,0,RV1159A,P9WI93,96.83904266357422
RVBD2674:msrB,0,0,0,0,0,RV2674,I6YA00,88.23963165283203
RVBD1473A:RVBD1473A,0,0,0,0,0,RV1473A,L7N691,83.69491577148438
RVBD2656c:RVBD2656c,0,0,0,0,0,RV2656c,P9WL49,85.8623046875
RVBD1531:RVBD1531,0,0,0,0,0,RV1531,O53905,97.34229278564453
RVBD0627:RVBD0627,0,0,0,0,0,RV0627,P96917,95.44007873535156
RVBD3571:kshB,0,0,0,0,0,RV3571,P9WJ93,94.11013793945312
RVBD3451:cut3,0,0,0,0,0,RV3451,P9WP39,82.41500091552734
RVBD0120c:fusA2,0,0,0,0,0,RV0120c,P9WNM9,91.1153564453125
RVBD1856c:RVBD1856c,0,0,0,0,0,RV1856c,P9WGQ1,89.81039428710938
RVBD1089A:celA2a,0,0,0,0,0,RV1089A,Q79FS6,71.85823822021484
RVBD2395B:RVBD2395B,0,0,0,0,0,RV2395B,V5QRX2,67.89962768554688
RVBD0680c:RVBD0680c,0,0,0,0,0,RV0680c,I6Y4F1,87.20919036865234
RVBD0610c:RVBD0610c,0,0,0,0,0,RV0610c,I6Y481,87.7577896118164
RVBD2547:RVBD2547,0,0,0,0,0,RV2547,P95006,90.61011505126953
RVBD1241:RVBD1241,0,0,0,0,0,RV1241,O50456,91.4088363647461
RVBD2735c:RVBD2735c,0,0,0,0,0,RV2735c,I6Y1K7,88.77851867675781
RVBD0181c:RVBD0181c,0,0,0,0,0,RV0181c,P9WI85,96.6618881225586
RVBD0137c:msrA,0,0,0,0,0,RV0137c,P9WJM5,93.5543441772461
RVBD1365c:rsfA,0,0,0,0,0,RV1365c,P9WGE3,91.22679901123047
RVBD1903:RVBD1903,0,0,0,0,0,RV1903,O07729,75.85365295410156
RVBD3855:ethR,0,0,0,0,0,RV3855,P9WMC1,91.78433990478516
RVBD1865c:RVBD1865c,0,0,0,0,0,RV1865c,P95150,90.91325378417969
RVBD1615:RVBD1615,0,0,0,0,0,RV1615,O06132,52.94280242919922
RVBD1767:RVBD1767,0,0,0,0,0,RV1767,O06800,94.18461608886719
RVBD3613c:RVBD3613c,0,0,0,0,0,RV3613c,O06270,61.679805755615234
RVBD1962A:vapB35,0,0,0,0,0,RV1962A,P9WF17,87.01611328125
RVBD1545:RVBD1545,0,0,0,0,0,RV1545,P9WLU9,48.12213134765625
RVBD3723:RVBD3723,0,0,0,0,0,RV3723,O69690,71.09425354003906
RVBD0376c:RVBD0376c,0,0,0,0,0,RV0376c,O53711,91.18081665039062
RVBD3123:RVBD3123,0,0,0,0,0,RV3123,O07034,64.95195007324219
RVBD3334:RVBD3334,0,0,0,0,0,RV3334,O53384,86.99911499023438
RVBD1773c:RVBD1773c,0,0,0,0,0,RV1773c,O06806,90.07088470458984
RVBD0268c:RVBD0268c,0,0,0,0,0,RV0268c,P95225,67.12940979003906
RVBD1169c:lipX,0,0,0,0,0,RV1169c,Q79FR5,95.03741455078125
RVBD1578c:RVBD1578c,0,0,0,0,0,RV1578c,O06612,88.05058288574219
RVBD0967:csoR,0,0,0,0,0,RV0967,P9WP49,83.18405151367188
RVBD2599:RVBD2599,0,0,0,0,0,RV2599,P9WL69,82.59616088867188
RVBD1105:RVBD1105,0,0,0,0,0,RV1105,O53453,86.46637725830078
RVBD1840c:PE-PGRS34,0,0,0,0,0,RV1840c,P9WIF3,94.1707992553711
RVBD0864:moaC2,0,0,0,0,0,RV0864,P9WJR7,92.1537094116211
RVBD3032A:RVBD3032A,0,0,0,0,0,RV3032A,I6X630,80.13705444335938
RVBD1395:RVBD1395,0,0,0,0,0,RV1395,P9WMJ1,89.19485473632812
RVBD3021c:RVBD3021c,0,0,0,0,0,RV3021c,P9WHY7,72.81563568115234
RVBD3056:dinP,0,0,0,0,0,RV3056,P9WNT1,95.09384155273438
RVBD0626:RVBD0626,0,0,0,0,0,RV0626,P9WF19,90.30640411376953
RVBD0516c:RVBD0516c,0,0,0,0,0,RV0516c,O33361,85.068603515625
RVBD0631c:recC,0,0,0,0,0,RV0631c,P9WIQ5,91.90165710449219
RVBD3119:moaE1,0,0,0,0,0,RV3119,P9WJR3,92.51904296875
RVBD1999c:RVBD1999c,0,0,0,0,0,RV1999c,P9WQM3,90.21642303466797
RVBD3819:RVBD3819,0,0,0,0,0,RV3819,O07804,91.85028076171875
RVBD2784c:lppU,0,0,0,0,0,RV2784c,I6XFA6,85.66783142089844
RVBD1243c:PE-PGRS23,0,0,0,0,0,RV1243c,Q79FQ7,94.91519165039062
RVBD3235:RVBD3235,0,0,0,0,0,RV3235,O05880,76.5841293334961
RVBD2810c:RVBD2810c,0,0,0,0,0,RV2810c,P71641,70.07752227783203
RVBD3074:RVBD3074,0,0,0,0,0,RV3074,I6XG38,87.9354019165039
RVBD2043c:pncA,0,0,0,0,0,RV2043c,I6XD65,97.12999725341797
RVBD2463:lipP,0,0,0,0,0,RV2463,O53190,95.63887786865234
RVBD2740:ephG,0,0,0,0,0,RV2740,O33283,94.54557037353516
RVBD1738:RVBD1738,0,0,0,0,0,RV1738,P9WLS3,90.91552734375
RVBD3678A:RVBD3678A,0,0,0,0,0,RV3678A,I6X824,91.8375473022461
RVBD2025c:RVBD2025c,0,0,0,0,0,RV2025c,P9WGF5,84.471923828125
RVBD3065:mmr,0,0,0,0,0,RV3065,P9WGF1,86.3990707397461
RVBD1323:fadA4,0,0,0,0,0,RV1323,P9WG69,97.89840698242188
RVBD2317:uspB,0,0,0,0,0,RV2317,L7N652,89.43737030029297
RVBD0250c:RVBD0250c,0,0,0,0,0,RV0250c,O53672,86.95927429199219
RVBD1637c:RVBD1637c,0,0,0,0,0,RV1637c,O06154,89.67166900634766
RVBD3309c:upp,0,0,0,0,0,RV3309c,P9WFF3,96.36550903320312
RVBD3395c:RVBD3395c,0,0,0,0,0,RV3395c,P9WKZ9,83.08980560302734
RVBD0735:sigL,0,0,0,0,0,RV0735,P9WGH5,86.21253967285156
RVBD2521:bcp,0,0,0,0,0,RV2521,P9WIE1,94.80293273925781
RVBD3888c:RVBD3888c,0,0,0,0,0,RV3888c,O05456,85.57213592529297
RVBD3362c:RVBD3362c,0,0,0,0,0,RV3362c,O50391,82.21404266357422
RVBD1932:tpx,0,0,0,0,0,RV1932,P9WG35,92.5926742553711
RVBD0380c:RVBD0380c,0,0,0,0,0,RV0380c,O53715,91.35613250732422
RVBD3181c:RVBD3181c,0,0,0,0,0,RV3181c,P9WF15,72.3420639038086
RVBD3523:ltp3,0,0,0,0,0,RV3523,I6YGD8,95.63323211669922
RVBD2052c:RVBD2052c,0,0,0,0,0,RV2052c,O53494,95.04867553710938
RVBD3546:fadA5,0,0,0,0,0,RV3546,I6XHI4,98.57547760009766
RVBD2038c:RVBD2038c,0,0,0,0,0,RV2038c,O53482,92.58915710449219
RVBD2636:RVBD2636,0,0,0,0,0,RV2636,P9WL55,92.87000274658203
RVBD2055c:rpsR,0,0,0,0,0,RV2055c,P9WH47,79.91636657714844
RVBD1720c:vapC12,0,0,0,0,0,RV1720c,P9WFA3,97.70442199707031
RVBD2023A:RVBD2023A,0,0,0,0,0,RV2023A,,
RVBD0665:vapC8,0,0,0,0,0,RV0665,P9WFB1,91.90919494628906
RVBD0867c:rpfA,0,0,0,0,0,RV0867c,P9WG31,61.60678482055664
RVBD1363c:RVBD1363c,0,0,0,0,0,RV1363c,P9WLZ9,79.70137023925781
RVBD0841:RVBD0841,0,0,0,0,0,RV0841,I6WZK3,69.63838195800781
RVBD2872:vapC43,0,0,0,0,0,RV2872,P9WF55,95.99747467041016
RVBD2190Ac:RVBD2190Ac,0,0,0,0,0,RV2190Ac,,
RVBD2450c:rpfE,0,0,0,0,0,RV2450c,O53177,76.66226959228516
RVBD0659c:RVBD0659c,0,0,0,0,0,RV0659c,P9WII1,96.54793548583984
RVBD1947:RVBD1947,0,0,0,0,0,RV1947,P95267,86.2724838256836
RVBD2895c:viuB,0,0,0,0,0,RV2895c,P9WL31,94.53003692626953
RVBD2016:RVBD2016,0,0,0,0,0,RV2016,O53462,81.11994171142578
RVBD2647:RVBD2647,0,0,0,0,0,RV2647,I6YDZ2,79.11966705322266
RVBD2662:RVBD2662,0,0,0,0,0,RV2662,P71959,63.728885650634766
RVBD3298c:lpqC,0,0,0,0,0,RV3298c,P96903,92.65960693359375
RVBD3552:RVBD3552,0,0,0,0,0,RV3552,P9WPV9,97.39199829101562
RVBD0298:RVBD0298,0,0,0,0,0,RV0298,P9WJ09,95.34959411621094
RVBD1419:RVBD1419,0,0,0,0,0,RV1419,P9WLX9,87.23674774169922
RVBD2085:RVBD2085,0,0,0,0,0,RV2085,P9WLJ9,59.091285705566406
RVBD3906c:RVBD3906c,0,0,0,0,0,RV3906c,O05439,87.49645233154297
RVBD1154c:RVBD1154c,0,0,0,0,0,RV1154c,O06552,84.15511322021484
RVBD3218:RVBD3218,0,0,0,0,0,RV3218,O05848,91.8066635131836
RVBD2811:RVBD2811,0,0,0,0,0,RV2811,P71640,91.91975402832031
RVBD1733c:RVBD1733c,0,0,0,0,0,RV1733c,P9WLS9,68.61357116699219
RVBD3831:RVBD3831,0,0,0,0,0,RV3831,P96247,93.84881591796875
RVBD1909c:furA,0,0,0,0,0,RV1909c,P9WN87,91.30904388427734
RVBD2389c:rpfD,0,0,0,0,0,RV2389c,P9WG27,73.27032470703125
RVBD2011c:RVBD2011c,0,0,0,0,0,RV2011c,P9WLM5,95.2277603149414
RVBD1862:adhA,0,0,0,0,0,RV1862,P9WQC1,95.23734283447266
RVBD3817:RVBD3817,0,0,0,0,0,RV3817,O07806,93.8349380493164
RVBD1741:vapC34,0,0,0,0,0,RV1741,P9WF71,69.4729232788086
RVBD3167c:RVBD3167c,0,0,0,0,0,RV3167c,O53317,85.659912109375
RVBD3190A:RVBD3190A,0,0,0,0,0,RV3190A,I6XGJ1,66.82913970947266
RVBD2816c:RVBD2816c,0,0,0,0,0,RV2816c,P9WPJ3,78.79151153564453
RVBD0379:secE2,0,0,0,0,0,RV0379,Q6MX43,93.24352264404297
RVBD2598:RVBD2598,0,0,0,0,0,RV2598,P9WL71,95.00707244873047
RVBD0827c:kmtR,0,0,0,0,0,RV0827c,O53838,87.49822998046875
RVBD2719c:RVBD2719c,0,0,0,0,0,RV2719c,I6YA32,61.89933776855469
RVBD3075c:RVBD3075c,0,0,0,0,0,RV3075c,I6YF40,90.23895263671875
RVBD2912c:RVBD2912c,0,0,0,0,0,RV2912c,P9WMC7,94.63856506347656
RVBD3622c:PE32,0,0,0,0,0,RV3622c,I6YGS7,95.74031066894531
RVBD1041c:RVBD1041c,0,0,0,0,0,RV1041c,P96360,67.79902648925781
RVBD1466:RVBD1466,0,0,0,0,0,RV1466,O53157,81.77269744873047
RVBD0608:vapB28,0,0,0,0,0,RV0608,P9WJ39,93.41567993164062
RVBD3022A:PE29,0,0,0,0,0,RV3022A,Q6MX17,96.31625366210938
RVBD1219c:RVBD1219c,0,0,0,0,0,RV1219c,O86312,94.21170043945312
RVBD2067c:RVBD2067c,0,0,0,0,0,RV2067c,P9WLL9,94.81946563720703
RVBD3064c:RVBD3064c,0,0,0,0,0,RV3064c,I6XG31,95.0926284790039
RVBD0100:RVBD0100,0,0,0,0,0,RV0100,P9WM65,94.61076354980469
RVBD2578c:RVBD2578c,0,0,0,0,0,RV2578c,P9WL79,87.89393615722656
RVBD2761c:hsdS,0,0,0,0,0,RV2761c,I6YEB1,90.11090087890625
RVBD0065:vapC1,0,0,0,0,0,RV0065,P9WFC1,95.67864227294922
RVBD3494c:mce4F,0,0,0,0,0,RV3494c,I6YC95,74.69994354248047
RVBD0891c:RVBD0891c,0,0,0,0,0,RV0891c,P9WMV1,74.76876831054688
RVBD2500c:fadE19,0,0,0,0,0,RV2500c,I6Y0W5,96.22040557861328
RVBD2886c:RVBD2886c,0,0,0,0,0,RV2886c,P9WL35,65.31915283203125
RVBD2634c:PE-PGRS46,0,0,0,0,0,RV2634c,P9WIE7,94.96700286865234
RVBD1870c:RVBD1870c,0,0,0,0,0,RV1870c,P95145,93.82843780517578
RVBD0278c:PE-PGRS3,0,0,0,0,0,RV0278c,P9WIG3,83.261474609375
RVBD0595c:vapC4,0,0,0,0,0,RV0595c,O07783,92.41145324707031
RVBD0089:RVBD0089,0,0,0,0,0,RV0089,P9WK03,92.3307113647461
RVBD2512A:RVBD2512A,0,0,0,0,0,RV2512A,,
RVBD1558:RVBD1558,0,0,0,0,0,RV1558,P9WP11,92.84053802490234
RVBD3047c:RVBD3047c,0,0,0,0,0,RV3047c,I6X642,45.5471305847168
RVBD2098c:RVBD2098c,0,0,0,0,0,RV2098c,,
RVBD3706c:RVBD3706c,0,0,0,0,0,RV3706c,I6X849,63.32783126831055
RVBD0277Ac:RVBD0277Ac,0,0,0,0,0,RV0277Ac,,
RVBD0158:RVBD0158,0,0,0,0,0,RV0158,O53641,91.92424774169922
RVBD2057c:rpmG1,0,0,0,0,0,RV2057c,P9WH97,87.51720428466797
RVBD2828A:RVBD2828A,0,0,0,0,0,RV2828A,I6YAC9,91.26708221435547
RVBD2226:RVBD2226,0,0,0,0,0,RV2226,P9WLH9,86.64476013183594
RVBD0590A:RVBD0590A,0,0,0,0,0,RV0590A,I6X9D2,84.72083282470703
RVBD0378:RVBD0378,0,0,0,0,0,RV0378,O53713,38.025753021240234
RVBD0039c:RVBD0039c,0,0,0,0,0,RV0039c,P9WM89,64.57721710205078
RVBD2307B:RVBD2307B,0,0,0,0,0,RV2307B,Q79FG2,68.14601135253906
RVBD1089:PE10,0,0,0,0,0,RV1089,L0T5T4,40.45191955566406
RVBD3642c:RVBD3642c,0,0,0,0,0,RV3642c,I6Y464,94.13687896728516
RVBD3697A:vapB48,0,0,0,0,0,RV3697A,P9WJ15,92.24783325195312
RVBD1762c:RVBD1762c,0,0,0,0,0,RV1762c,O06797,86.56370544433594
RVBD2709:RVBD2709,0,0,0,0,0,RV2709,I6YA25,57.21966552734375
RVBD1560:vapB11,0,0,0,0,0,RV1560,P9WLU3,84.49722290039062
RVBD0122:RVBD0122,0,0,0,0,0,RV0122,O07172,67.10163879394531
RVBD1597:RVBD1597,0,0,0,0,0,RV1597,O06593,95.43254089355469
RVBD1997:ctpF,0,0,0,0,0,RV1997,P9WPS9,83.03573608398438
RVBD2349c:plcC,0,0,0,0,0,RV2349c,P9WIB1,87.06614685058594
RVBD0995:rimJ,0,0,0,0,0,RV0995,O05578,97.3699951171875
RVBD2824c:RVBD2824c,0,0,0,0,0,RV2824c,P9WPJ1,84.03289794921875
RVBD2126c:PE-PGRS37,0,0,0,0,0,RV2126c,L0TBL4,92.80081939697266
RVBD1210:tagA,0,0,0,0,0,RV1210,O05311,93.17386627197266
RVBD1525:wbbL2,0,0,0,0,0,RV1525,P9WLV3,90.6794204711914
RVBD1336:cysM,0,0,0,0,0,RV1336,P9WP53,94.05937957763672
RVBD1984A:RVBD1984A,0,0,0,0,0,RV1984A,,
RVBD2411c:RVBD2411c,0,0,0,0,0,RV2411c,P9WLA9,83.85000610351562
RVBD1789:PPE26,0,0,0,0,0,RV1789,Q79FK6,70.87615966796875
RVBD3751:RVBD3751,0,0,0,0,0,RV3751,O69718,87.31098175048828
RVBD0863:RVBD0863,0,0,0,0,0,RV0863,I6XWF9,69.0705337524414
RVBD0241c:htdX,0,0,0,0,0,RV0241c,O53664,93.52470397949219
RVBD2061c:RVBD2061c,0,0,0,0,0,RV2061c,O86340,95.71350860595703
RVBD2335:cysE,0,0,0,0,0,RV2335,P95231,88.14820861816406
RVBD1152:RVBD1152,0,0,0,0,0,RV1152,O06550,90.16337585449219
RVBD1235:lpqY,0,0,0,0,0,RV1235,P9WGU9,92.7156753540039
RVBD3668c:RVBD3668c,0,0,0,0,0,RV3668c,I6YGW2,92.17564392089844
RVBD2546:vapC18,0,0,0,0,0,RV2546,P95007,97.40803527832031
RVBD3525c:RVBD3525c,0,0,0,0,0,RV3525c,I6YCB9,97.978515625
RVBD1290A:RVBD1290A,0,0,0,0,0,RV1290A,Q79FQ6,37.929039001464844
RVBD0674:RVBD0674,0,0,0,0,0,RV0674,I6WZ26,90.52241516113281
RVBD6032:tRNA-Lys30,0,0,0,0,0,RV6032,,
RVBD0547c:RVBD0547c,0,0,0,0,0,RV0547c,O06413,92.60356903076172
RVBD3686c:RVBD3686c,0,0,0,0,0,RV3686c,O69654,62.11981201171875
RVBD1287:RVBD1287,0,0,0,0,0,RV1287,P9WME3,90.0434799194336
RVBD2342:RVBD2342,0,0,0,0,0,RV2342,P95238,66.19176483154297
RVBD1104:RVBD1104,0,0,0,0,0,RV1104,O53452,86.4109115600586
RVBD2031c:hspX,0,0,0,0,0,RV2031c,P9WMK1,81.56673431396484
RVBD1868:RVBD1868,0,0,0,0,0,RV1868,P95147,89.56954956054688
RVBD2892c:PPE45,0,0,0,0,0,RV2892c,P9WHZ1,64.93097686767578
RVBD3651:RVBD3651,0,0,0,0,0,RV3651,I6YCP0,89.96808624267578
RVBD2306B:RVBD2306B,0,0,0,0,0,RV2306B,Q79FG4,58.05778121948242
RVBD2183c:RVBD2183c,0,0,0,0,0,RV2183c,O53517,68.98892211914062
RVBD2675c:RVBD2675c,0,0,0,0,0,RV2675c,I6Y1G8,92.35932159423828
RVBD3226c:RVBD3226c,0,0,0,0,0,RV3226c,O05872,90.6185302734375
RVBD3363c:RVBD3363c,0,0,0,0,0,RV3363c,O50392,86.84942626953125
RVBD0302:RVBD0302,0,0,0,0,0,RV0302,O07229,91.36590576171875
RVBD0092:ctpA,0,0,0,0,0,RV0092,P9WPU1,80.66314697265625
RVBD2994:RVBD2994,0,0,0,0,0,RV2994,P9WJW7,88.96321868896484
RVBD3564:fadE33,0,0,0,0,0,RV3564,I6YCF5,96.31103515625
RVBD2998A:RVBD2998A,0,0,0,0,0,RV2998A,Q6MX20,91.00656127929688
RVBD2268c:cyp128,0,0,0,0,0,RV2268c,P9WPN7,81.29557800292969
RVBD3161c:RVBD3161c,0,0,0,0,0,RV3161c,O53311,92.98783111572266
RVBD1444c:RVBD1444c,0,0,0,0,0,RV1444c,O06815,86.81448364257812
RVBD3549c:RVBD3549c,0,0,0,0,0,RV3549c,I6YCE1,95.19344329833984
RVBD2855:mtr,0,0,0,0,0,RV2855,P9WHH3,97.68701171875
RVBD2270:lppN,0,0,0,0,0,RV2270,P9WK73,81.80908966064453
RVBD3513c:fadD18,0,0,0,0,0,RV3513c,I6YGC8,78.86830139160156
RVBD0924c:mntH,0,0,0,0,0,RV0924c,P9WIZ5,80.60453796386719
RVBD0186Ac:RVBD0186Ac,0,0,0,0,0,RV0186Ac,,
RVBD0232:RVBD0232,0,0,0,0,0,RV0232,P96415,92.9352798461914
RVBD1944c:RVBD1944c,0,0,0,0,0,RV1944c,P95270,76.90708923339844
RVBD2770c:PPE44,0,0,0,0,0,RV2770c,P9WHZ3,71.0304946899414
RVBD3486:RVBD3486,0,0,0,0,0,RV3486,O06349,86.02662658691406
RVBD2087:RVBD2087,0,0,0,0,0,RV2087,P9WLJ7,77.63856506347656
RVBD1247c:RVBD1247c,0,0,0,0,0,RV1247c,O50462,96.0383071899414
RVBD2976c:ung,0,0,0,0,0,RV2976c,P9WFQ9,96.35810089111328
RVBD1587c:RVBD1587c,0,0,0,0,0,RV1587c,O06603,69.59326934814453
RVBD0617:vapC29,0,0,0,0,0,RV0617,P9WF79,96.19023132324219
RVBD2056c:rpsN,0,0,0,0,0,RV2056c,P9WH59,96.55416870117188
RVBD2231B:RVBD2231B,0,0,0,0,0,RV2231B,P0CW31,74.43879699707031
RVBD3164c:moxR3,0,0,0,0,0,RV3164c,O53314,93.89615631103516
RVBD3335c:RVBD3335c,0,0,0,0,0,RV3335c,O53385,78.3543930053711
RVBD0550c:RVBD0550c,0,0,0,0,0,RV0550c,P9WJ59,86.4815902709961
RVBD2905:lppW,0,0,0,0,0,RV2905,P9WK67,86.83130645751953
RVBD3503c:fdxD,0,0,0,0,0,RV3503c,I6X7H4,97.54143524169922
RVBD3007c:RVBD3007c,0,0,0,0,0,RV3007c,O53254,79.59162139892578
RVBD1638A:RVBD1638A,0,0,0,0,0,RV1638A,L7N673,85.44058227539062
RVBD2027c:dosT,0,0,0,0,0,RV2027c,P9WGK1,85.26713562011719
RVBD0280:PPE3,0,0,0,0,0,RV0280,P9WI45,69.10770416259766
RVBD3135:PPE50,0,0,0,0,0,RV3135,Q6MX07,91.95545196533203
RVBD0515:RVBD0515,0,0,0,0,0,RV0515,O33360,87.54656219482422
RVBD0912:RVBD0912,0,0,0,0,0,RV0912,O05904,79.42738342285156
RVBD2492:RVBD2492,0,0,0,0,0,RV2492,I6YDJ7,91.56063842773438
RVBD0353:hspR,0,0,0,0,0,RV0353,O06302,87.04658508300781
RVBD2307c:RVBD2307c,0,0,0,0,0,RV2307c,P9WLC7,94.79345703125
RVBD3061c:fadE22,0,0,0,0,0,RV3061c,I6X654,93.71439361572266
RVBD0855:far,0,0,0,0,0,RV0855,I6Y8Y0,96.0120849609375
RVBD1544:RVBD1544,0,0,0,0,0,RV1544,Q10782,93.69850158691406
RVBD2853:PE-PGRS48,0,0,0,0,0,RV2853,Q6MX26,96.06642150878906
RVBD2142c:parE2,0,0,0,0,0,RV2142c,P9WHG5,94.900390625
RVBD0611c:RVBD0611c,0,0,0,0,0,RV0611c,I6XVR9,76.1705551147461
RVBD0960:RVBD0960,0,0,0,0,0,RV0960,P9WFA9,96.61189270019531
RVBD0031:RVBD0031,0,0,0,0,0,RV0031,P71601,69.95128631591797
RVBD1096:RVBD1096,0,0,0,0,0,RV1096,O53444,87.08931732177734
RVBD2865:relF,0,0,0,0,0,RV2865,O33347,94.39494323730469
RVBD2108:PPE36,0,0,0,0,0,RV2108,P9WI01,80.81844329833984
RVBD1591:RVBD1591,0,0,0,0,0,RV1591,P9WLT5,86.25521850585938
RVBD1715:fadB3,0,0,0,0,0,RV1715,L7N688,94.71088409423828
RVBD1748:RVBD1748,0,0,0,0,0,RV1748,P72005,83.88987731933594
RVBD3742c:RVBD3742c,0,0,0,0,0,RV3742c,O69709,54.959999084472656
RVBD1744c:RVBD1744c,0,0,0,0,0,RV1744c,O06787,85.21150207519531
RVBD0366c:RVBD0366c,0,0,0,0,0,RV0366c,O53701,92.15161895751953
RVBD0692:RVBD0692,0,0,0,0,0,RV0692,P95038,89.49964141845703
RVBD3094c:RVBD3094c,0,0,0,0,0,RV3094c,O05773,97.03718566894531
RVBD1191:RVBD1191,0,0,0,0,0,RV1191,O05293,91.22351837158203
RVBD2506:RVBD2506,0,0,0,0,0,RV2506,O06169,90.7235336303711
RVBD3183:RVBD3183,0,0,0,0,0,RV3183,O53333,93.07559967041016
RVBD1239c:corA,0,0,0,0,0,RV1239c,O50455,86.60704803466797
RVBD1818c:PE-PGRS33,0,0,0,0,0,RV1818c,P9WIF5,95.3919448852539
RVBD1858:modB,0,0,0,0,0,RV1858,P9WG13,92.26966094970703
RVBD3430c:RVBD3430c,0,0,0,0,0,RV3430c,I6YC39,72.81458282470703
RVBD2337c:RVBD2337c,0,0,0,0,0,RV2337c,P95233,90.66553497314453
RVBD2301:cut2,0,0,0,0,0,RV2301,P9WP41,86.57030487060547
RVBD2368c:phoH1,0,0,0,0,0,RV2368c,P9WIA3,85.59003448486328
RVBD0196:RVBD0196,0,0,0,0,0,RV0196,P9WME1,94.49588012695312
RVBD0446c:RVBD0446c,0,0,0,0,0,RV0446c,O53731,94.17292785644531
RVBD3584:lpqE,0,0,0,0,0,RV3584,P9WK63,81.70143127441406
RVBD2189c:RVBD2189c,0,0,0,0,0,RV2189c,O53523,90.55548858642578
RVBD3585:radA,0,0,0,0,0,RV3585,P9WHJ9,83.10447692871094
RVBD0396:RVBD0396,0,0,0,0,0,RV0396,P95204,81.22645568847656
RVBD1849:ureB,0,0,0,0,0,RV1849,P9WFE9,96.48210144042969
RVBD0349:RVBD0349,0,0,0,0,0,RV0349,O06300,92.42858123779297
RVBD0586:mce2R,0,0,0,0,0,RV0586,P9WMG5,91.8779525756836
RVBD2528c:mrr,0,0,0,0,0,RV2528c,I6Y9K2,86.2746353149414
RVBD2626c:hrp1,0,0,0,0,0,RV2626c,P9WJA3,91.62237548828125
RVBD2654c:RVBD2654c,0,0,0,0,0,RV2654c,P9WJ11,75.2082748413086
RVBD1387:PPE20,0,0,0,0,0,RV1387,P9WI23,66.18338012695312
RVBD1112:RVBD1112,0,0,0,0,0,RV1112,O53459,89.47010803222656
RVBD0749A:RVBD0749A,0,0,0,0,0,RV0749A,I6X9Q1,77.62045288085938
RVBD1660:pks10,0,0,0,0,0,RV1660,P9WPF5,96.92710876464844
RVBD2486:echA14,0,0,0,0,0,RV2486,P9WNN5,94.44223022460938
RVBD1087:PE-PGRS21,0,0,0,0,0,RV1087,Q79FT0,86.5047378540039
RVBD3086:adhD,0,0,0,0,0,RV3086,P9WQB9,97.1752700805664
RVBD3098c:RVBD3098c,0,0,0,0,0,RV3098c,O05776,41.89067077636719
RVBD0825c:RVBD0825c,0,0,0,0,0,RV0825c,O53836,85.57020568847656
RVBD1198:esxL,0,0,0,0,0,RV1198,P9WNJ5,94.44766998291016
RVBD1771:RVBD1771,0,0,0,0,0,RV1771,P9WIT3,95.5349349975586
RVBD1434:RVBD1434,0,0,0,0,0,RV1434,O06824,74.51378631591797
RVBD0781:ptrBa,0,0,0,0,0,RV0781,P71835,86.8524169921875
RVBD2608:PPE42,0,0,0,0,0,RV2608,P9WHZ5,88.62906646728516
RVBD2313c:RVBD2313c,0,0,0,0,0,RV2313c,P9WLB7,96.25823974609375
RVBD0333:RVBD0333,0,0,0,0,0,RV0333,O33273,89.42903137207031
RVBD3865:espF,0,0,0,0,0,RV3865,P9WJD1,91.52542877197266
RVBD2639c:RVBD2639c,0,0,0,0,0,RV2639c,P9WFN9,81.15972137451172
RVBD1203c:RVBD1203c,0,0,0,0,0,RV1203c,O05304,96.1324691772461
RVBD2304c:RVBD2304c,0,0,0,0,0,RV2304c,P9WLD3,51.36884307861328
RVBD1779c:RVBD1779c,0,0,0,0,0,RV1779c,O53930,71.45889282226562
RVBD0959A:vapB9,0,0,0,0,0,RV0959A,P9WJ55,94.75685119628906
RVBD2430c:PPE41,0,0,0,0,0,RV2430c,Q79FE1,92.19551086425781
RVBD2385:mbtJ,0,0,0,0,0,RV2385,Q79FE8,90.92182159423828
RVBD0923c:RVBD0923c,0,0,0,0,0,RV0923c,I6XWK6,94.15331268310547
RVBD2014:RVBD2014,0,0,0,0,0,RV2014,Q10843,95.95892333984375
RVBD3472:RVBD3472,0,0,0,0,0,RV3472,I6YG83,96.22928619384766
RVBD1255c:RVBD1255c,0,0,0,0,0,RV1255c,P9WMD5,90.0733642578125
RVBD2742c:RVBD2742c,0,0,0,0,0,RV2742c,O33285,50.30643081665039
RVBD3717:RVBD3717,0,0,0,0,0,RV3717,I6Y4D2,94.08708953857422
RVBD3182:RVBD3182,0,0,0,0,0,RV3182,O53332,93.34771728515625
RVBD1291c:RVBD1291c,0,0,0,0,0,RV1291c,P9WM33,76.7149658203125
RVBD1433:RVBD1433,0,0,0,0,0,RV1433,O06825,87.74642181396484
RVBD3538:RVBD3538,0,0,0,0,0,RV3538,Q6MWW2,95.45044708251953
RVBD1669:RVBD1669,0,0,0,0,0,RV1669,O86371,31.699499130249023
RVBD0354c:PPE7,0,0,0,0,0,RV0354c,L0T545,68.76063537597656
RVBD1135c:PPE16,0,0,0,0,0,RV1135c,P9WI29,90.93601989746094
RVBD1553:frdB,0,0,0,0,0,RV1553,P9WN89,96.01688385009766
RVBD1585c:RVBD1585c,0,0,0,0,0,RV1585c,O06605,32.08356857299805
RVBD0712:RVBD0712,0,0,0,0,0,RV0712,I6Y8I5,92.82080078125
RVBD1892:RVBD1892,0,0,0,0,0,RV1892,O07740,76.96437072753906
RVBD3354:RVBD3354,0,0,0,0,0,RV3354,O50383,75.80728149414062
RVBD2722:RVBD2722,0,0,0,0,0,RV2722,O33227,52.1150016784668
RVBD1128c:RVBD1128c,0,0,0,0,0,RV1128c,P9WM57,89.63871002197266
RVBD2717c:RVBD2717c,0,0,0,0,0,RV2717c,P9WFG7,96.87371826171875
RVBD1193:fadD36,0,0,0,0,0,RV1193,O05295,93.08440399169922
RVBD0394c:RVBD0394c,0,0,0,0,0,RV0394c,P95202,81.94568634033203
RVBD2273:RVBD2273,0,0,0,0,0,RV2273,P9WLF3,66.82853698730469
RVBD1583c:RVBD1583c,0,0,0,0,0,RV1583c,P9WLU1,85.27758026123047
RVBD2850c:RVBD2850c,0,0,0,0,0,RV2850c,P9WPR3,78.44406127929688
RVBD3360:RVBD3360,0,0,0,0,0,RV3360,O50389,85.73966979980469
RVBD1509:RVBD1509,0,0,0,0,0,RV1509,P9WLW3,92.8399658203125
RVBD1980c:mpt64,0,0,0,0,0,RV1980c,P9WIN9,87.84087371826172
RVBD2395A:aprA,0,0,0,0,0,RV2395A,V5QPR9,65.19310760498047
RVBD0794c:RVBD0794c,0,0,0,0,0,RV0794c,I6Y4U4,95.16111755371094
RVBD0752c:fadE9,0,0,0,0,0,RV0752c,I6Y4R2,97.3541030883789
RVBD0633c:RVBD0633c,0,0,0,0,0,RV0633c,P96923,78.11845397949219
RVBD2429:ahpD,0,0,0,0,0,RV2429,P9WQB5,97.66231536865234
RVBD2941:fadD28,0,0,0,0,0,RV2941,P9WQ59,90.16085815429688
RVBD2338c:moeW,0,0,0,0,0,RV2338c,P95234,90.54625701904297
RVBD2629:RVBD2629,0,0,0,0,0,RV2629,P9WL63,84.15824127197266
RVBD1353c:RVBD1353c,0,0,0,0,0,RV1353c,P9WMD3,86.99612426757812
RVBD3528c:RVBD3528c,0,0,0,0,0,RV3528c,I6YGE4,94.09683227539062
RVBD2035:RVBD2035,0,0,0,0,0,RV2035,O53479,94.70661163330078
RVBD0375c:RVBD0375c,0,0,0,0,0,RV0375c,I6Y7N2,96.21356964111328
RVBD2493:vapB38,0,0,0,0,0,RV2493,P9WJ25,92.35657501220703
RVBD0972c:fadE12,0,0,0,0,0,RV0972c,P9WQG3,95.1634750366211
RVBD2352c:PPE38,0,0,0,0,0,RV2352c,P9WHZ9,68.98848724365234
RVBD3695:RVBD3695,0,0,0,0,0,RV3695,O69663,82.42271423339844
RVBD2961:RVBD2961,0,0,0,0,0,RV2961,P95131,93.16241455078125
RVBD0321:dcd,0,0,0,0,0,RV0321,P9WP17,96.27921295166016
RVBD1864c:RVBD1864c,0,0,0,0,0,RV1864c,P95151,90.13916015625
RVBD3747:RVBD3747,0,0,0,0,0,RV3747,O69714,89.56771087646484
RVBD1065:RVBD1065,0,0,0,0,0,RV1065,O53413,90.66271209716797
RVBD0212c:nadR,0,0,0,0,0,RV0212c,P96394,92.87826538085938
RVBD3897c:RVBD3897c,0,0,0,0,0,RV3897c,O07036,53.60694885253906
RVBD2375:RVBD2375,0,0,0,0,0,RV2375,O05823,84.81800842285156
RVBD1075c:RVBD1075c,0,0,0,0,0,RV1075c,O53423,84.15617370605469
RVBD0444c:rskA,0,0,0,0,0,RV0444c,P9WGX5,83.64207458496094
RVBD3241c:RVBD3241c,0,0,0,0,0,RV3241c,O05886,77.65370178222656
RVBD1552:frdA,0,0,0,0,0,RV1552,P9WN91,95.59400939941406
RVBD3878:espJ,0,0,0,0,0,RV3878,P9WJC3,60.813140869140625
RVBD1982c:vapC36,0,0,0,0,0,RV1982c,P9WF65,96.80612182617188
RVBD1313c:RVBD1313c,0,0,0,0,0,RV1313c,P9WKH7,91.355712890625
RVBD1962c:RVBD1962c,0,0,0,0,0,RV1962c,P9WF67,97.29874420166016
RVBD3072c:RVBD3072c,0,0,0,0,0,RV3072c,P95086,70.0387954711914
RVBD3496c:mce4D,0,0,0,0,0,RV3496c,I6XHD6,78.46981048583984
RVBD1167c:RVBD1167c,0,0,0,0,0,RV1167c,O50423,88.37010192871094
RVBD2107:PE22,0,0,0,0,0,RV2107,L7N6B5,95.39214324951172
RVBD1190:RVBD1190,0,0,0,0,0,RV1190,O86348,96.45146942138672
RVBD1889c:RVBD1889c,0,0,0,0,0,RV1889c,O07743,94.18169403076172
RVBD0581:RVBD0581,0,0,0,0,0,RV0581,O53778,95.91365814208984
RVBD1885c:RVBD1885c,0,0,0,0,0,RV1885c,P9WIB9,89.33175659179688
RVBD0612:RVBD0612,0,0,0,0,0,RV0612,I6X9E8,72.75511932373047
RVBD3547:ddn,0,0,0,0,0,RV3547,P9WP15,91.74423217773438
RVBD1786:RVBD1786,0,0,0,0,0,RV1786,O53937,94.95999908447266
RVBD1890c:RVBD1890c,0,0,0,0,0,RV1890c,O07742,90.82108306884766
RVBD0201c:RVBD0201c,0,0,0,0,0,RV0201c,O53652,88.93389892578125
RVBD0678:RVBD0678,0,0,0,0,0,RV0678,I6Y8F7,91.9561767578125
RVBD1186c:RVBD1186c,0,0,0,0,0,RV1186c,O50442,86.83139038085938
RVBD0434:RVBD0434,0,0,0,0,0,RV0434,P96280,92.28359985351562
RVBD1549:fadD11.1,0,0,0,0,0,RV1549,P9WLU5,84.11137390136719
RVBD0854:RVBD0854,0,0,0,0,0,RV0854,I6X9Y7,95.75163269042969
RVBD3439c:RVBD3439c,0,0,0,0,0,RV3439c,I6YC49,71.64669799804688
RVBD0918:RVBD0918,0,0,0,0,0,RV0918,O05910,75.8141098022461
RVBD0572c:RVBD0572c,0,0,0,0,0,RV0572c,P9WM81,50.82637405395508
RVBD1803c:PE-PGRS32,0,0,0,0,0,RV1803c,Q79FJ9,92.44730377197266
RVBD3110:moaB1,0,0,0,0,0,RV3110,Q6MX13,85.90450286865234
RVBD1663:pks17,0,0,0,0,0,RV1663,O06585,81.3830337524414
RVBD1335:cysO,0,0,0,0,0,RV1335,P9WP33,95.29492950439453
RVBD0264c:RVBD0264c,0,0,0,0,0,RV0264c,P95221,93.35848236083984
RVBD0369c:RVBD0369c,0,0,0,0,0,RV0369c,O53704,75.19666290283203
RVBD2561:RVBD2561,0,0,0,0,0,RV2561,P9WL99,82.68939208984375
RVBD3902c:RVBD3902c,0,0,0,0,0,RV3902c,O05443,95.2887954711914
RVBD3875:esxA,0,0,0,0,0,RV3875,P9WNK7,83.65210723876953
RVBD3120:RVBD3120,0,0,0,0,0,RV3120,O05796,91.74535369873047
RVBD0301:vapC2,0,0,0,0,0,RV0301,P9WFB9,95.45339965820312
RVBD0925c:RVBD0925c,0,0,0,0,0,RV0925c,I6Y946,94.1493148803711
RVBD2289:cdh,0,0,0,0,0,RV2289,P9WPG9,89.52950286865234
RVBD2616:RVBD2616,0,0,0,0,0,RV2616,O06198,90.62451934814453
RVBD1924c:RVBD1924c,0,0,0,0,0,RV1924c,P95289,60.759925842285156
RVBD0371c:RVBD0371c,0,0,0,0,0,RV0371c,I6WY86,92.91608428955078
RVBD3203:lipV,0,0,0,0,0,RV3203,L0TC47,96.66191101074219
RVBD0400c:fadE7,0,0,0,0,0,RV0400c,P95208,97.74491882324219
RVBD0840c:pip,0,0,0,0,0,RV0840c,I6Y8X0,97.27262115478516
RVBD1051c:RVBD1051c,0,0,0,0,0,RV1051c,O53399,84.83879852294922
RVBD1265:RVBD1265,0,0,0,0,0,RV1265,P9WM49,78.7876968383789
RVBD3204:RVBD3204,0,0,0,0,0,RV3204,O05862,94.18206787109375
RVBD3069:RVBD3069,0,0,0,0,0,RV3069,P9WP63,91.21878051757812
RVBD1137c:RVBD1137c,0,0,0,0,0,RV1137c,O06537,31.91262435913086
RVBD0845:RVBD0845,0,0,0,0,0,RV0845,O53857,77.46054077148438
RVBD2494:vapC38,0,0,0,0,0,RV2494,O53219,96.05885314941406
RVBD1118c:RVBD1118c,0,0,0,0,0,RV1118c,O06570,74.05574035644531
RVBD2271:RVBD2271,0,0,0,0,0,RV2271,P9WLF7,95.71273040771484
RVBD2104c:vapB37,0,0,0,0,0,RV2104c,P9WJ27,93.12940979003906
RVBD2718c:nrdR,0,0,0,0,0,RV2718c,P9WIZ1,93.34798431396484
RVBD3557c:RVBD3557c,0,0,0,0,0,RV3557c,P9WMB9,94.54259490966797
RVBD1839c:vapB13,0,0,0,0,0,RV1839c,P9WJ51,89.49666595458984
RVBD3811:RVBD3811,0,0,0,0,0,RV3811,Q79F96,82.27175903320312
RVBD0010c:RVBD0010c,0,0,0,0,0,RV0010c,P9WMA3,83.79886627197266
RVBD3282:RVBD3282,0,0,0,0,0,RV3282,P9WK27,95.04183959960938
RVBD1117:RVBD1117,0,0,0,0,0,RV1117,O06569,97.90851593017578
RVBD1988:erm(37),0,0,0,0,0,RV1988,Q10838,90.3255844116211
RVBD0336:RVBD0336,0,0,0,0,0,RV0336,O33266,87.4017562866211
RVBD2831:echA16,0,0,0,0,0,RV2831,I6YEH6,94.28803253173828
RVBD1927:RVBD1927,0,0,0,0,0,RV1927,P95287,88.63236999511719
RVBD3233c:RVBD3233c,0,0,0,0,0,RV3233c,O05878,87.4033203125
RVBD2033c:RVBD2033c,0,0,0,0,0,RV2033c,O53477,89.4198226928711
RVBD2263:RVBD2263,0,0,0,0,0,RV2263,O53537,92.5337905883789
RVBD0632c:echA3,0,0,0,0,0,RV0632c,I6Y8B5,97.40354919433594
RVBD2856B:RVBD2856B,0,0,0,0,0,RV2856B,,
RVBD0255c:cobQ1,0,0,0,0,0,RV0255c,P9WP95,92.50516510009766
RVBD2054:RVBD2054,0,0,0,0,0,RV2054,O86353,92.91126251220703
RVBD1471:trxB1,0,0,0,0,0,RV1471,L7N664,90.55137634277344
RVBD3077:RVBD3077,0,0,0,0,0,RV3077,Q6MX15,94.26339721679688
RVBD1761c:RVBD1761c,0,0,0,0,0,RV1761c,O06796,87.89418029785156
RVBD2875:mpt70,0,0,0,0,0,RV2875,P9WNF5,79.565185546875
RVBD2788:sirR,0,0,0,0,0,RV2788,I6Y1Q2,93.40592193603516
RVBD1805c:RVBD1805c,0,0,0,0,0,RV1805c,O53954,54.58460998535156
RVBD1260:RVBD1260,0,0,0,0,0,RV1260,P9WM51,95.06941223144531
RVBD0136:cyp138,0,0,0,0,0,RV0136,P9WPM3,92.4592514038086
RVBD1271c:RVBD1271c,0,0,0,0,0,RV1271c,P9WM43,78.98247528076172
RVBD0470A:RVBD0470A,0,0,0,0,0,RV0470A,L7N651,65.06390380859375
RVBD1776c:RVBD1776c,0,0,0,0,0,RV1776c,O33179,87.73860931396484
RVBD1445c:devB,0,0,0,0,0,RV1445c,P9WQP5,97.7860336303711
RVBD1126c:RVBD1126c,0,0,0,0,0,RV1126c,O06578,95.5575180053711
RVBD1204c:RVBD1204c,0,0,0,0,0,RV1204c,O05305,89.61371612548828
RVBD2893:RVBD2893,0,0,0,0,0,RV2893,I6YEN3,95.80611419677734
RVBD2632c:RVBD2632c,0,0,0,0,0,RV2632c,P9WL61,89.59622955322266
RVBD3415c:RVBD3415c,0,0,0,0,0,RV3415c,I6YG27,95.26937866210938
RVBD1142c:echA10,0,0,0,0,0,RV1142c,O06542,95.92496490478516
RVBD3889c:espG2,0,0,0,0,0,RV3889c,P9WJC9,94.20046997070312
RVBD1838c:vapC13,0,0,0,0,0,RV1838c,P9WFA1,96.23617553710938
RVBD1706c:PPE23,0,0,0,0,0,RV1706c,E2FZM4,62.83753967285156
RVBD3188:RVBD3188,0,0,0,0,0,RV3188,O53334,95.55653381347656
RVBD3407:vapB47,0,0,0,0,0,RV3407,P9WF23,88.05879211425781
RVBD1541c:lprI,0,0,0,0,0,RV1541c,P9WK41,90.08284759521484
RVBD1994c:cmtR,0,0,0,0,0,RV1994c,P9WMI9,78.6235580444336
RVBD2436:rbsK,0,0,0,0,0,RV2436,P71913,91.99618530273438
RVBD1851:ureF,0,0,0,0,0,RV1851,P9WFE5,96.39236450195312
RVBD3499c:mce4A,0,0,0,0,0,RV3499c,I6YC99,85.41522216796875
RVBD1950c:RVBD1950c,0,0,0,0,0,RV1950c,P95264,85.82826232910156
RVBD2396:PE-PGRS41,0,0,0,0,0,RV2396,Q79FE6,91.93586730957031
RVBD3251c:rubA,0,0,0,0,0,RV3251c,O05894,93.25071716308594
RVBD1915:aceAa,0,0,0,0,0,RV1915,O07718,83.7878189086914
RVBD1907c:RVBD1907c,0,0,0,0,0,RV1907c,L0TAY1,74.96074676513672
RVBD2595:vapB40,0,0,0,0,0,RV2595,P9WFC3,92.97370147705078
RVBD2212:RVBD2212,0,0,0,0,0,RV2212,P9WMU7,88.9367446899414
RVBD2090:RVBD2090,0,0,0,0,0,RV2090,P9WNU3,96.59304809570312
RVBD2644c:RVBD2644c,0,0,0,0,0,RV2644c,P9WL53,48.11275863647461
RVBD0370c:RVBD0370c,0,0,0,0,0,RV0370c,O53705,92.51889038085938
RVBD1252c:lprE,0,0,0,0,0,RV1252c,P9WK49,77.0496597290039
RVBD1322:RVBD1322,0,0,0,0,0,RV1322,P9WM27,79.89530944824219
RVBD0850:RVBD0850,0,0,0,0,0,RV0850,I6Y8X8,65.18273162841797
RVBD1344:mbtL,0,0,0,0,0,RV1344,P9WQF1,82.49512481689453
RVBD1632c:RVBD1632c,0,0,0,0,0,RV1632c,O06149,95.76238250732422
RVBD0221:RVBD0221,0,0,0,0,0,RV0221,P9WKB7,89.73270416259766
RVBD2083:RVBD2083,0,0,0,0,0,RV2083,P9WLK3,57.094520568847656
RVBD3861:RVBD3861,0,0,0,0,0,RV3861,P96216,33.94972229003906
RVBD1563c:treY,0,0,0,0,0,RV1563c,P9WQ21,96.83695220947266
RVBD0071:RVBD0071,0,0,0,0,0,RV0071,O53616,70.0208969116211
RVBD2406c:RVBD2406c,0,0,0,0,0,RV2406c,P71737,95.23372650146484
RVBD0965c:RVBD0965c,0,0,0,0,0,RV0965c,P9WKM3,79.28675842285156
RVBD1668c:RVBD1668c,0,0,0,0,0,RV1668c,O53916,80.31269073486328
RVBD2068c:blaC,0,0,0,0,0,RV2068c,P9WKD3,91.3294448852539
RVBD0629c:recD,0,0,0,0,0,RV0629c,P9WHJ1,90.87986755371094
RVBD2034:RVBD2034,0,0,0,0,0,RV2034,O53478,90.90962982177734
RVBD0868c:moaD2,0,0,0,0,0,RV0868c,I6XWG2,84.41130065917969
RVBD1040c:PE8,0,0,0,0,0,RV1040c,L7N667,63.225894927978516
RVBD3400:RVBD3400,0,0,0,0,0,RV3400,P9WKZ7,93.83473205566406
RVBD2053c:fxsA,0,0,0,0,0,RV2053c,O53495,62.41594314575195
RVBD1519:RVBD1519,0,0,0,0,0,RV1519,P9WLV7,58.868202209472656
RVBD1848:ureA,0,0,0,0,0,RV1848,P9WFE7,97.27230834960938
RVBD3197A:whiB7,0,0,0,0,0,RV3197A,Q6MX01,88.47315216064453
RVBD0833:PE-PGRS13,0,0,0,0,0,RV0833,Q79FV7,90.14332580566406
RVBD1144Ac:RVBD1144Ac,0,0,0,0,0,RV1144Ac,,
RVBD3745c:RVBD3745c,0,0,0,0,0,RV3745c,O69712,94.44285583496094
RVBD1740:vapB34,0,0,0,0,0,RV1740,P9WJ31,88.81228637695312
RVBD2757c:RVBD2757c,0,0,0,0,0,RV2757c,P9WF91,96.29586791992188
RVBD2424c:RVBD2424c,0,0,0,0,0,RV2424c,P71924,88.3154067993164
RVBD2336:RVBD2336,0,0,0,0,0,RV2336,P95232,79.79692840576172
RVBD2472:RVBD2472,0,0,0,0,0,RV2472,O53199,58.23020553588867
RVBD1347c:mbtK,0,0,0,0,0,RV1347c,P9WK15,91.45448303222656
RVBD3566c:nat,0,0,0,0,0,RV3566c,P9WJI5,95.3154067993164
RVBD3291c:lrpA,0,0,0,0,0,RV3291c,I6YBQ3,96.34133911132812
RVBD3857Ac:RVBD3857Ac,0,0,0,0,0,RV3857Ac,,
RVBD0798c:cfp29,0,0,0,0,0,RV0798c,I6WZG6,96.48871612548828
RVBD3611:RVBD3611,0,0,0,0,0,RV3611,O06272,36.93096923828125
RVBD2867c:RVBD2867c,0,0,0,0,0,RV2867c,I6XFI7,93.8609848022461
RVBD1812c:RVBD1812c,0,0,0,0,0,RV1812c,P9WJJ1,96.8603286743164
RVBD2755c:hsdS.1,0,0,0,0,0,RV2755c,I6XF84,95.10317993164062
RVBD1967:mce3B,0,0,0,0,0,RV1967,O53968,86.66900634765625
RVBD0134:ephF,0,0,0,0,0,RV0134,P96811,94.091064453125
RVBD0583c:lpqN,0,0,0,0,0,RV0583c,O53780,85.23516845703125
RVBD3091:RVBD3091,0,0,0,0,0,RV3091,I6YB49,83.86393737792969
RVBD2806:RVBD2806,0,0,0,0,0,RV2806,I6YAA5,72.94792938232422
RVBD3847:RVBD3847,0,0,0,0,0,RV3847,P96230,93.14977264404297
RVBD1116A:RVBD1116A,0,0,0,0,0,RV1116A,L7N6A9,44.88275146484375
RVBD2671:ribD,0,0,0,0,0,RV2671,P71968,93.90096282958984
RVBD0690c:RVBD0690c,0,0,0,0,0,RV0690c,I6Y4G1,96.05701446533203
RVBD0165c:mce1R,0,0,0,0,0,RV0165c,Q79G00,78.44305419921875
RVBD0609:vapC28,0,0,0,0,0,RV0609,P9WF81,95.39225769042969
RVBD0240:vapC24,0,0,0,0,0,RV0240,P9WF87,96.32234954833984
RVBD3467:RVBD3467,0,0,0,0,0,RV3467,Q50655,85.34475708007812
RVBD0530Ac:RVBD0530Ac,0,0,0,0,0,RV0530Ac,,
RVBD0307c:RVBD0307c,0,0,0,0,0,RV0307c,O07234,89.03662109375
RVBD1863c:RVBD1863c,0,0,0,0,0,RV1863c,P95152,92.67898559570312
RVBD3095:RVBD3095,0,0,0,0,0,RV3095,P9WMG3,90.40689849853516
RVBD0910:RVBD0910,0,0,0,0,0,RV0910,P9WJ05,96.65020751953125
RVBD3098A:RVBD3098A,0,0,0,0,0,RV3098A,V5QRX7,93.3375473022461
RVBD1734c:RVBD1734c,0,0,0,0,0,RV1734c,P9WLS7,86.9857406616211
RVBD2070c:cobK,0,0,0,0,0,RV2070c,P9WP89,95.24614715576172
RVBD2297:RVBD2297,0,0,0,0,0,RV2297,P9WLD9,80.60113525390625
RVBD1963c:mce3R,0,0,0,0,0,RV1963c,P95251,85.9826431274414
RVBD1736c:narX,0,0,0,0,0,RV1736c,P9WJQ1,88.32749938964844
RVBD0599c:RVBD0599c,0,0,0,0,0,RV0599c,O07779,87.09718322753906
RVBD2369c:RVBD2369c,0,0,0,0,0,RV2369c,L0TC46,52.731300354003906
RVBD1284:canA,0,0,0,0,0,RV1284,P9WPJ7,97.66300964355469
RVBD2022c:RVBD2022c,0,0,0,0,0,RV2022c,O53468,72.30084991455078
RVBD3617:ephA,0,0,0,0,0,RV3617,I6YGS0,96.5260009765625
RVBD3315c:cdd,0,0,0,0,0,RV3315c,P9WPH3,96.58444213867188
RVBD3018c:PPE46,0,0,0,0,0,RV3018c,P9WHY9,72.91129302978516
RVBD1269c:RVBD1269c,0,0,0,0,0,RV1269c,P9WM45,84.56967163085938
RVBD2801c:RVBD2801c,0,0,0,0,0,RV2801c,P71650,97.46296691894531
RVBD3361c:RVBD3361c,0,0,0,0,0,RV3361c,I6YBX3,97.69300842285156
RVBD0027:RVBD0027,0,0,0,0,0,RV0027,P9WM99,93.5172348022461
RVBD2570:RVBD2570,0,0,0,0,0,RV2570,P9WL91,96.47480773925781
RVBD2237:RVBD2237,0,0,0,0,0,RV2237,P9WLH1,95.44627380371094
RVBD3399:RVBD3399,0,0,0,0,0,RV3399,P9WFH1,79.46746826171875
RVBD0392c:ndhA,0,0,0,0,0,RV0392c,P95200,93.20259094238281
RVBD3693:RVBD3693,0,0,0,0,0,RV3693,O69661,93.19621276855469
RVBD2891:RVBD2891,0,0,0,0,0,RV2891,P9WL33,75.3671875
RVBD2667:clpC2,0,0,0,0,0,RV2667,P9WPC7,85.2872543334961
RVBD3387:RVBD3387,0,0,0,0,0,RV3387,O50414,93.24942779541016
RVBD1214c:PE14,0,0,0,0,0,RV1214c,L7N6A7,96.39273071289062
RVBD2312:RVBD2312,0,0,0,0,0,RV2312,P9WLB9,71.69190216064453
RVBD0738:RVBD0738,0,0,0,0,0,RV0738,P9WKS3,96.51235961914062
RVBD0260c:RVBD0260c,0,0,0,0,0,RV0260c,P95217,91.17658233642578
RVBD3887c:eccD2,0,0,0,0,0,RV3887c,P9WNQ5,86.76441955566406
RVBD3681c:whiB4,0,0,0,0,0,RV3681c,P9WF39,89.5485610961914
RVBD1474c:RVBD1474c,0,0,0,0,0,RV1474c,O53165,93.18096160888672
RVBD2386A:RVBD2386A,0,0,0,0,0,RV2386A,I6YD99,83.37913513183594
RVBD1394c:cyp132,0,0,0,0,0,RV1394c,P9WPN3,86.68717956542969
RVBD2862c:RVBD2862c,0,0,0,0,0,RV2862c,I6Y1W7,86.29562377929688
RVBD1883c:RVBD1883c,0,0,0,0,0,RV1883c,O07748,90.6682357788086
RVBD2791c:RVBD2791c,0,0,0,0,0,RV2791c,O33333,86.97137451171875
RVBD1314c:RVBD1314c,0,0,0,0,0,RV1314c,P9WP99,94.12787628173828
RVBD0865:mog,0,0,0,0,0,RV0865,I6Y8Y8,95.4260025024414
RVBD2478c:RVBD2478c,0,0,0,0,0,RV2478c,O53205,81.54708099365234
RVBD2548:vapC19,0,0,0,0,0,RV2548,P9WF93,97.72502136230469
RVBD0551c:fadD8,0,0,0,0,0,RV0551c,O06417,88.2265625
RVBD0215c:fadE3,0,0,0,0,0,RV0215c,P96397,96.49105834960938
RVBD3071:RVBD3071,0,0,0,0,0,RV3071,P95087,85.09495544433594
RVBD1262c:RVBD1262c,0,0,0,0,0,RV1262c,P9WML1,92.49042510986328
RVBD2550c:vapB20,0,0,0,0,0,RV2550c,P9WJ45,87.65917205810547
RVBD3353c:RVBD3353c,0,0,0,0,0,RV3353c,O50382,81.37152099609375
RVBD0985c:mscL,0,0,0,0,0,RV0985c,P9WJN5,78.60867309570312
RVBD0330c:RVBD0330c,0,0,0,0,0,RV0330c,O07254,91.71654510498047
RVBD3488:RVBD3488,0,0,0,0,0,RV3488,I6X7F9,91.21736907958984
RVBD2213:pepB,0,0,0,0,0,RV2213,P9WHT3,96.24742126464844
RVBD2527:vapC17,0,0,0,0,0,RV2527,P9WF95,95.32939910888672
RVBD1249c:RVBD1249c,0,0,0,0,0,RV1249c,O50464,69.25820922851562
RVBD1778c:RVBD1778c,0,0,0,0,0,RV1778c,O33181,92.29261779785156
RVBD3638:RVBD3638,0,0,0,0,0,RV3638,I6XHU7,81.8772201538086
RVBD2417c:RVBD2417c,0,0,0,0,0,RV2417c,P9WP05,94.4952163696289
RVBD3845:RVBD3845,0,0,0,0,0,RV3845,P96233,72.57286834716797
RVBD2326c:RVBD2326c,0,0,0,0,0,RV2326c,P9WQI7,83.89188385009766
RVBD1590:RVBD1590,0,0,0,0,0,RV1590,P9WLT7,86.87520599365234
RVBD2071c:cobM,0,0,0,0,0,RV2071c,P9WGB1,95.09461975097656
RVBD3426:PPE58,0,0,0,0,0,RV3426,Q50702,70.82572937011719
RVBD3092c:RVBD3092c,0,0,0,0,0,RV3092c,I6Y2I9,83.36203002929688
RVBD2878c:mpt53,0,0,0,0,0,RV2878c,P9WG65,91.74272155761719
RVBD0121c:RVBD0121c,0,0,0,0,0,RV0121c,O07171,90.57902526855469
RVBD1954A:RVBD1954A,0,0,0,0,0,RV1954A,P0CV86,50.56449890136719
RVBD2543:lppA,0,0,0,0,0,RV2543,P9WK81,84.4964828491211
RVBD2591:PE-PGRS44,0,0,0,0,0,RV2591,P9WIE9,95.41559600830078
RVBD0406c:RVBD0406c,0,0,0,0,0,RV0406c,O86336,90.17371368408203
RVBD1231c:RVBD1231c,0,0,0,0,0,RV1231c,O86314,80.70467376708984
RVBD3836:RVBD3836,0,0,0,0,0,RV3836,P96242,81.27999877929688
RVBD1138c:RVBD1138c,0,0,0,0,0,RV1138c,O06538,93.63594818115234
RVBD0262c:aac,0,0,0,0,0,RV0262c,P9WQG9,96.2518310546875
RVBD3688c:RVBD3688c,0,0,0,0,0,RV3688c,I6X831,95.91156005859375
RVBD1855c:RVBD1855c,0,0,0,0,0,RV1855c,P95159,96.10582733154297
RVBD2227:RVBD2227,0,0,0,0,0,RV2227,P9WLH7,76.68819427490234
RVBD3384c:RVBD3384c,0,0,0,0,0,RV3384c,O50411,97.25322723388672
RVBD1584c:RVBD1584c,0,0,0,0,0,RV1584c,O06606,89.23725891113281
RVBD1000c:RVBD1000c,0,0,0,0,0,RV1000c,L7N6A4,89.42561340332031
RVBD1951c:RVBD1951c,0,0,0,0,0,RV1951c,P95263,84.93602752685547
RVBD1561:vapC11,0,0,0,0,0,RV1561,P9WFA5,97.9143295288086
RVBD3699:RVBD3699,0,0,0,0,0,RV3699,O69667,92.0488052368164
RVBD2003c:RVBD2003c,0,0,0,0,0,RV2003c,P9WJZ5,77.67235565185547
RVBD3530c:RVBD3530c,0,0,0,0,0,RV3530c,I6Y3S9,96.62223052978516
RVBD1080c:greA,0,0,0,0,0,RV1080c,P9WMT9,86.75603485107422
RVBD0150c:RVBD0150c,0,0,0,0,0,RV0150c,P96827,45.37631607055664
RVBD2771c:RVBD2771c,0,0,0,0,0,RV2771c,O33313,97.93572998046875
RVBD2896c:RVBD2896c,0,0,0,0,0,RV2896c,P9WL29,93.33316802978516
RVBD0691A:RVBD0691A,0,0,0,0,0,RV0691A,P9WJ81,77.46102905273438
RVBD1045:RVBD1045,0,0,0,0,0,RV1045,P96356,95.89767456054688
RVBD3112:moaD1,0,0,0,0,0,RV3112,L7N6B4,94.2239761352539
RVBD0691c:RVBD0691c,0,0,0,0,0,RV0691c,P9WMB7,91.65015411376953
RVBD0217c:lipW,0,0,0,0,0,RV0217c,P96399,93.97013092041016
RVBD2191:RVBD2191,0,0,0,0,0,RV2191,P9WLJ1,83.3238525390625
RVBD1004c:RVBD1004c,0,0,0,0,0,RV1004c,O05589,50.04391098022461
RVBD1035c:RVBD1035c,0,0,0,0,0,RV1035c,P96366,85.6865005493164
RVBD2645:RVBD2645,0,0,0,0,0,RV2645,P9WL51,65.25713348388672
RVBD2856A:RVBD2856A,0,0,0,0,0,RV2856A,,
RVBD2768c:PPE43,0,0,0,0,0,RV2768c,Q79FA9,70.43811798095703
RVBD3452:cut4,0,0,0,0,0,RV3452,O06319,85.82460021972656
RVBD2208:cobS,0,0,0,0,0,RV2208,P9WP91,95.84075927734375
RVBD2725c:hflX,0,0,0,0,0,RV2725c,O33230,75.05908966064453
RVBD0078B:RVBD0078B,0,0,0,0,0,RV0078B,I6X8G2,90.4561767578125
RVBD0656c:vapC6,0,0,0,0,0,RV0656c,P9WFB5,87.50370788574219
RVBD1686c:RVBD1686c,0,0,0,0,0,RV1686c,O33188,89.85968780517578
RVBD2132:RVBD2132,0,0,0,0,0,RV2132,O06243,86.5628890991211
RVBD0770:RVBD0770,0,0,0,0,0,RV0770,P9WNY3,94.90776062011719
RVBD6001:tRNA-Ala2,0,0,0,0,0,RV6001,,
RVBD2260:RVBD2260,0,0,0,0,0,RV2260,O53534,97.56251525878906
RVBD3307:deoD,0,0,0,0,0,RV3307,P9WP01,93.95917510986328
RVBD0439c:RVBD0439c,0,0,0,0,0,RV0439c,O53726,91.87141418457031
RVBD0523c:RVBD0523c,0,0,0,0,0,RV0523c,O06389,90.18893432617188
RVBD1679:fadE16,0,0,0,0,0,RV1679,O53926,96.46160888671875
RVBD1245c:RVBD1245c,0,0,0,0,0,RV1245c,O50460,94.9097900390625
RVBD2044c:RVBD2044c,0,0,0,0,0,RV2044c,O53487,77.83600616455078
RVBD0296c:RVBD0296c,0,0,0,0,0,RV0296c,Q6MX51,92.81307220458984
RVBD3250c:rubB,0,0,0,0,0,RV3250c,I6YFL7,89.47349548339844
RVBD0898c:RVBD0898c,0,0,0,0,0,RV0898c,P9WKP5,84.22884368896484
RVBD2046:lppI,0,0,0,0,0,RV2046,O53489,89.16913604736328
RVBD0804:RVBD0804,0,0,0,0,0,RV0804,I6Y4V2,95.0404281616211
RVBD3724A:cut5a,0,0,0,0,0,RV3724A,Q79FA5,82.41188049316406
RVBD1581c:RVBD1581c,0,0,0,0,0,RV1581c,O06609,86.64336395263672
RVBD3191c:RVBD3191c,0,0,0,0,0,RV3191c,O53337,85.48363494873047
RVBD3422c:RVBD3422c,0,0,0,0,0,RV3422c,P9WFS7,85.44464111328125
RVBD2638:RVBD2638,0,0,0,0,0,RV2638,I6X4W0,89.69743347167969
RVBD0749:vapC31,0,0,0,0,0,RV0749,P9WF75,96.53704071044922
RVBD3073c:RVBD3073c,0,0,0,0,0,RV3073c,P9WL11,87.29873657226562
RVBD2099c:RVBD2099c,0,0,0,0,0,RV2099c,,
RVBD2080:lppJ,0,0,0,0,0,RV2080,P9WK77,85.88850402832031
RVBD3491:RVBD3491,0,0,0,0,0,RV3491,I6XHD1,80.36380004882812
RVBD0748:vapB31,0,0,0,0,0,RV0748,O53811,88.9093017578125
RVBD1982A:vapB36,0,0,0,0,0,RV1982A,P9WJ29,85.799072265625
RVBD2607:pdxH,0,0,0,0,0,RV2607,P9WIJ1,94.4307632446289
RVBD2681:RVBD2681,0,0,0,0,0,RV2681,I6XF17,90.45475006103516
RVBD2545:vapB18,0,0,0,0,0,RV2545,P9WJ47,46.199241638183594
RVBD2951c:RVBD2951c,0,0,0,0,0,RV2951c,P9WIB7,94.09603881835938
RVBD2252:RVBD2252,0,0,0,0,0,RV2252,P9WP29,92.79769897460938
RVBD1576c:RVBD1576c,0,0,0,0,0,RV1576c,O06614,83.14822387695312
